You open your eyes. Your eyesight is blurry and it takes a while for you to realize that you are staring straight up at the cloudless blue sky. The faint squawk of birds slowly gets louder as you come back to your senses.  Still in a daze, you slowly sit up and look around. You find yourself sitting on the soft white sand of an empty beach. How in the world did you end up here? Your clothes is tattered and your entire body aches with pain. Carefully, you stand up and walk around, letting the warm sand slip through your bare toes. After examining your surroundings a bit more, you realize that you're on a small Island.

Trouble in the Tropics
An Interactive Fiction by Braden Yoshinaga
Release 1 / Serial number 140311 / Inform 7 build 6G60 (I6/v6.32 lib 6/12N) SD

Beach
A beautiful white sand beach that stretches around the entire island. Waves from the vast, sapphire ocean gently lap the shore. The sand here is littered with many crab holes. Palm trees line the dirt farther north up the beach. The clearing is to the north.

You can see a thin line here.

>x island
You're standing on it!

* * *

>take line
Taken.

* * *

>n
Clearing
A wide open grassy clearing that is surrounded by a ring of palm trees. You can see a feeble lone tree in the center of the clearing and a cluster of boulders near the edge of the clearing. You can also see a mud pit near the boulders. Four paths from all directions intersect here. The volcano slope is to the north, the dirt path is to the west, the wetlands are to the east, and the beach is to the south.

>take rock
Taken.

* * *

>take worm
Taken.

>shake tree
You grab hold of the feeble trunk and shake it gently. A skinny branch detaches iteself from the trunk and falls to the ground. You take a closer look at the branch and see that it is actually a strong, flexible stick.

* * *

>fish
(in the small ponds)
You throw your line in the pond and wait for a bite. It's not long until you feel something tugging on your line. You pull in your line and take the raw mullet on the end.

>w
Clearing
A wide open grassy clearing that is surrounded by a ring of palm trees. You can see a feeble lone tree in the center of the clearing and a cluster of boulders near the edge of the clearing. You can also see a mud pit near the boulders. Four paths from all directions intersect here. The volcano slope is to the north, the dirt path is to the west, the wetlands are to the east, and the beach is to the south.

* * *

>combine handle with rock
You shove the sharp rock into the wooden handle. You have created a stone axe.

>break door
What do you want to break the door with?

>break door with axe
You chop and break the wooden planks. You can now open the door.

* * *

>give scientist mullet
The scientist hungrily snatches the cooked mullet out of your hands.

>talk to scientist
Thank you so much, I was literally dying of starvation. Anyways, if you're trying to get off this island, there's a secret lab under the volcano to the north. Take this key to the locked gate to the west. You may find something useful in the cave. Also, take these goggles to the lava tube on the east side of the island. With these special goggles, You should be able to find the passcode to the lab. But beware, a creature lurks in the depths of the cave to the west. If you get near, it won't hesitate to kill you right then and there. You should be safe from the creature once you get to the tunnel under the volcano. Be careful

>s
Dirt Path
An old dirt path lined with greenery. There is a hut to the north and a gate to the west.

>wear goggles
You put on the special goggles.

>e
Clearing
A wide open grassy clearing that is surrounded by a ring of palm trees. You can see a feeble lone tree in the center of the clearing and a cluster of boulders near the edge of the clearing. You can also see a mud pit near the boulders. Four paths from all directions intersect here. The volcano slope is to the north, the dirt path is to the west, the wetlands are to the east, and the beach is to the south.

* * *

>w
Clearing
A wide open grassy clearing that is surrounded by a ring of palm trees. You can see a feeble lone tree in the center of the clearing and a cluster of boulders near the edge of the clearing. You can also see a mud pit near the boulders. Four paths from all directions intersect here. The volcano slope is to the north, the dirt path is to the west, the wetlands are to the east, and the beach is to the south.

>w
Dirt Path
An old dirt path lined with greenery. There is a hut to the north and a gate to the west.

>x gate
A giant gate that covers the entire mouth of a cave. The gate is littered with warning and danger signs. How eerie. On the front of the gate is a keyhole in the shape of an hourglass. This gate is probably here for a reason

>w
The gate at the cave entrance is locked.

* * *

>e
Wetlands
A series of small ponds surrounded by tall grass and mangrove plants. The lava tube is to the north and the clearing is to the west.

>n
Lava Tube
An old lava tube that is now empty. There are strange markings engraved into the shiny black rock walls. The wetlands are to the south and the volcano slope is to the west.

>x walls
The special goggles filter the markings on the wall, leaving only the faint scratches visible. You can clearly make out the number "133716" engraved in the wall. You pick up a leaf and scratch the number in with your fingernail. You put the leaf in your pocket.

>w
Volcano Slope
The slope of a towering active volcano in the middle of the island. The slope is covered with ash and underbrush. There is a small lava pit at the foot of the slope. The lava tube is to the east and the clearing is to the south.

* * *

>x volcano
A towering volcano thats peak is hidden in the clouds. The underbrush covering the volcano looks a little strange.

>x underbrush
Volcanic ferns and skinny trees that are rooted on the slope of the volcano. You notice a door built into the side of the volcano behind one of the ferns.

>x door
A hidden stone door placed under the underbrush on the volcano slope. In the middle of the door is an indent that is shaped like the front of a skull.

>s
Clearing
A wide open grassy clearing that is surrounded by a ring of palm trees. You can see a feeble lone tree in the center of the clearing and a cluster of boulders near the edge of the clearing. You can also see a mud pit near the boulders. Four paths from all directions intersect here. The volcano slope is to the north, the dirt path is to the west, the wetlands are to the east, and the beach is to the south.

* * *

>key
You unlock the Gate.

>open gate
The gate opens with a loud creak that echoes through the dark cave. The creaking of the gate is followed by a distant growl from somewhere far inside the cave.

>w
Cave
A dark and spacious cave that seems to extend much farther undergound. The only sound that can be heard here is the water droplets falling from the ceiling. The dirt path is to the east.

You can see a mysterious stone here.

* * *

>take stone
(the mysterious stone)
Taken.

>x stone
Which do you mean, the mysterious stone or the Stone axe?

>mysterious stone
An odd-looking stone that resembles a human skull.

* * *

>i
You are carrying:
  a mysterious stone
  a code
  a special goggles (being worn)
  a Stone axe
  a fishing rod

>l
Dirt Path
An old dirt path lined with greenery. There is a hut to the north and a gate to the west.

>e
Clearing
A wide open grassy clearing that is surrounded by a ring of palm trees. You can see a feeble lone tree in the center of the clearing and a cluster of boulders near the edge of the clearing. You can also see a mud pit near the boulders. Four paths from all directions intersect here. The volcano slope is to the north, the dirt path is to the west, the wetlands are to the east, and the beach is to the south.

* * *

>n
Volcano Slope
The slope of a towering active volcano in the middle of the island. The slope is covered with ash and underbrush. There is a small lava pit at the foot of the slope. The lava tube is to the east and the clearing is to the south.

>n
The hidden door is locked.

>unlock door with stone
Which do you mean, the mysterious stone or the Stone axe?

>mysterious stone
You unlock the Hidden Door.

>open door
You open the Hidden Door.

A dreadful howl pierces the air. It sounds like it came from the Cave. Maybe you should stay away from whatever that was.

The creature is now at the Dirt Path.

>n
Dark Tunnel
A dark tunnel dug under the slope of the volcano that looks to be man-made. The air is warm and the walls are lined with broken tunnel lights. Further down the tunnel, there are two large metal doors. One is to the north and one is to the east. There is an electronic keypad mounted on the wall between the two doors.

The creature is now at the Dirt Path.

>close door
Which do you mean, the North Metal Door, the East Metal Door or the Hidden Door?

>hidden door
You close the Hidden Door.

You must supply a noun.

The creature is now at the Dirt Path.

>x keypad
A small electric keypad located on the wall between the north and east lab doors. Located on the keypad are ten buttons: one for every number from 0-9.

The creature is now at the Dirt Path.

>enter code
You enter the number "133716" into the electronic keypad. After a while, you hear a small beeping sound coming from both the north and east metal doors. As soon as the beeping stops, both doors slide open with a puff of white mist.

The creature is now at the Dirt Path.

>e
Secret Lab
A secret lab built under a volcano? Sounds like something straight out of a sci-fi movie! Flasks and beakers of different shapes and sizes line the shelves and tabletops. Rows of beeping machines are located in the far corner of the lab. The dark tunnel is to the east and the experiment room is to the north.

You can see an uncharged battery and a key card here.

The creature is now at the Dirt Path.

>x battery
A big and heavy battery that is too big for any normal electronic device. The battery is dead but might be refillable. On the side of the battery is a label that reads: x+y.

The creature is now at the Dirt Path.

>take key card
Taken.

The creature is now at the Dirt Path.

>x card
A key card that once belonged to a scientist.

You must supply a noun.

The creature is now at the Dirt Path.

>n
Experiment Room
A dark room packed with empty animal pens and cages. Giant claw marks stretch across the blood-stained walls. There are three large cryo tubes sitting in the middle of the room. Next to one of the cryo tubes is a small sample safe. The underground cove is to the west and the secret lab is to the south.

You can see a sample safe (closed) here.

You must supply a noun.

The creature is now at the Dirt Path.

>x pens
Empty cages and pens that looks to once have held many different types of animals.

The creature is now at the Dirt Path.

>x cages
Empty cages and pens that looks to once have held many different types of animals.

You must supply a noun.

The creature is now at the Dirt Path.

>x pens
Empty cages and pens that looks to once have held many different types of animals.

You must supply a noun.

The creature is now at the Dirt Path.

>s
Secret Lab
A secret lab built under a volcano? Sounds like something straight out of a sci-fi movie! Flasks and beakers of different shapes and sizes line the shelves and tabletops. Rows of beeping machines are located in the far corner of the lab. The dark tunnel is to the east and the experiment room is to the north.

You can see an uncharged battery here.

The creature is now at the Dirt Path.

>n
Experiment Room
A dark room packed with empty animal pens and cages. Giant claw marks stretch across the blood-stained walls. There are three large cryo tubes sitting in the middle of the room. Next to one of the cryo tubes is a small sample safe. The underground cove is to the west and the secret lab is to the south.

You can see a sample safe (closed) here.

You must supply a noun.

The creature is now at the Dirt Path.

* * *

>x pens
Empty cages and pens that looks to once have held many different types of animals.

The creature is now at the Dirt Path.

>x sample safe
A small glass sample safe that contains three liquid-filled vials labeled x, y, and z. There is a card slot on the safe door.

The creature is now at the Dirt Path.

>unlock safe
What do you want to unlock the sample safe with?

>key card
You unlock the sample safe.

The creature is now at the Dirt Path.

>open safe
You open the sample safe, revealing Vial x, Vial y and Vial z.

The creature is now at the Dirt Path.

>take x
Taken.

The creature is now at the Dirt Path.

>take y
Taken.

The creature is now at the Dirt Path.

>mix x and y
You can't use multiple objects with that verb.

>mix x with y
You now have battery fluid.

The creature is now at the Dirt Path.

>put battery fluid in uncharged battery
You can't see any such thing.

>i
You are carrying:
  battery fluid
  a key card
  a mysterious stone
  a code
  a special goggles (being worn)
  a Stone axe
  a fishing rod

The creature is now at the Dirt Path.

>s
Secret Lab
A secret lab built under a volcano? Sounds like something straight out of a sci-fi movie! Flasks and beakers of different shapes and sizes line the shelves and tabletops. Rows of beeping machines are located in the far corner of the lab. The dark tunnel is to the east and the experiment room is to the north.

You can see an uncharged battery here.

The creature is now at the Dirt Path.

>take uncharged battery
Taken.

The creature is now at the Dirt Path.

>put battery fluid in uncharged battery
You now have a charged battery.

The creature is now at the Dirt Path.

>w
Dark Tunnel
A dark tunnel dug under the slope of the volcano that looks to be man-made. The air is warm and the walls are lined with broken tunnel lights. Further down the tunnel, there are two large metal doors. One is to the north and one is to the east. There is an electronic keypad mounted on the wall between the two doors.

The creature is now at the Dirt Path.

>open hidden door
You open the Hidden Door.

The creature is now at the Dirt Path.

>s
Volcano Slope
The slope of a towering active volcano in the middle of the island. The slope is covered with ash and underbrush. There is a small lava pit at the foot of the slope. The lava tube is to the east and the clearing is to the south.

The creature is now in the Clearing.

>n
Dark Tunnel
A dark tunnel dug under the slope of the volcano that looks to be man-made. The air is warm and the walls are lined with broken tunnel lights. Further down the tunnel, there are two large metal doors. One is to the north and one is to the east. There is an electronic keypad mounted on the wall between the two doors.

The creature is now in the Clearing.

>n
Underground Cove
A hidden cove where the ocean flows underneath the volcano. This cove serves as a secret lab entrance for boats and other ocean vehicles. There is a small submarine floating in the water. The dark tunnel is to the south and the experiment room is to the east.

You can see a Broken submarine (empty) here.

The creature is now in the Clearing.

>fix sub
You plug the charged battery into the empty space next to the engine. You climb into the submarine and start the engine. The propeller successfuly starts and you begin your descent away from the island. As you descend deeper, your surroundings slowly fade until you are engulfed in an empty white world.
 You open your eyes. Your eyesight is blurry and it takes a while for you to realize that you are staring straight up at a white ceiling. Still in a daze, you slowly sit up and look around. You realize that you're sitting on your bed in your bedroom. What an odd dream

    *** You have won ***

Would you like to RESTART, RESTORE a saved game, QUIT or UNDO the last command?

* * *

>n
Clearing
A wide open grassy clearing that is surrounded by a ring of palm trees. You can see a feeble lone tree in the center of the clearing and a cluster of boulders near the edge of the clearing. You can also see a mud pit near the boulders. Four paths from all directions intersect here. The volcano slope is to the north, the dirt path is to the west, the wetlands are to the east, and the beach is to the south.

>shake tree
You grab hold of the feeble trunk and shake it gently. A skinny branch detaches iteself from the trunk and falls to the ground. You take a closer look at the branch and see that it is actually a strong, flexible stick.

* * *

>take stick
Taken.

>x boulders
A patch of large, black boulders. Most boulders are too large to move but there are other, smaller rocks scattered around.

You can see a sharp rock here.

* * *

>take rock
Taken.

>x mud
A small pit filled with warm, thick mud.

You can see a worm on the surface of the mud.

>take worm
Taken.

>combine stick with line
You tie the fishing line into a notch at the end of the stick. You have created an unfinished rod.

* * *

>combine rod with worm
You tie the worm to the end of the fishing line on the unfinished rod. You have created a fishing rod.

>east
Wetlands
A series of small ponds surrounded by tall grass and mangrove plants. The lava tube is to the north and the clearing is to the west.

>fish
(in the small ponds)
You throw your line in the pond and wait for a bite. It's not long until you feel something tugging on your line. You pull in your line and take the raw mullet on the end.

>west
Clearing
A wide open grassy clearing that is surrounded by a ring of palm trees. You can see a feeble lone tree in the center of the clearing and a cluster of boulders near the edge of the clearing. You can also see a mud pit near the boulders. Four paths from all directions intersect here. The volcano slope is to the north, the dirt path is to the west, the wetlands are to the east, and the beach is to the south.

>north
Volcano Slope
The slope of a towering active volcano in the middle of the island. The slope is covered with ash and underbrush. There is a small lava pit at the foot of the slope. The lava tube is to the east and the clearing is to the south.

>cook fish
(in the small lava pit)
You carefully hold the raw mullet over the fire pit. After a while, the mullet cooks and becomes brown and crispy. You now have a cooked mullet.

>south
Clearing
A wide open grassy clearing that is surrounded by a ring of palm trees. You can see a feeble lone tree in the center of the clearing and a cluster of boulders near the edge of the clearing. You can also see a mud pit near the boulders. Four paths from all directions intersect here. The volcano slope is to the north, the dirt path is to the west, the wetlands are to the east, and the beach is to the south.

>west
Dirt Path
An old dirt path lined with greenery. There is a hut to the north and a gate to the west.

You can see a wooden handle here.

>take handle
Taken.

* * *

>open door
You open the Wooden Door.

>north
Old Shack
A dark and musty shack. The walls are lined with shelves that hold misshapen skulls, flasks, and other unusual objects. How odd. The dirt path is to the south.

You can see a Scientist here.

>give scientist cooked mullet
The scientist hungrily snatches the cooked mullet out of your hands.

>talk to scientist
Thank you so much, I was literally dying of starvation. Anyways, if you're trying to get off this island, there's a secret lab under the volcano to the north. Take this key to the locked gate to the west. You may find something useful in the cave. Also, take these goggles to the lava tube on the east side of the island. With these special goggles, You should be able to find the passcode to the lab. But beware, a creature lurks in the depths of the cave to the west. If you get near, it won't hesitate to kill you right then and there. You should be safe from the creature once you get to the tunnel under the volcano. Be careful

>wear goggles
You put on the special goggles.

>south
Dirt Path
An old dirt path lined with greenery. There is a hut to the north and a gate to the west.

>unlock gate with rusty key
You unlock the Gate.

>open gate
The gate opens with a loud creak that echoes through the dark cave. The creaking of the gate is followed by a distant growl from somewhere far inside the cave.

>west
Cave
A dark and spacious cave that seems to extend much farther undergound. The only sound that can be heard here is the water droplets falling from the ceiling. The dirt path is to the east.

You can see a mysterious stone here.

>take mysterious stone
Taken.

* * *

>east
Clearing
A wide open grassy clearing that is surrounded by a ring of palm trees. You can see a feeble lone tree in the center of the clearing and a cluster of boulders near the edge of the clearing. You can also see a mud pit near the boulders. Four paths from all directions intersect here. The volcano slope is to the north, the dirt path is to the west, the wetlands are to the east, and the beach is to the south.

>east
Wetlands
A series of small ponds surrounded by tall grass and mangrove plants. The lava tube is to the north and the clearing is to the west.

>north
Lava Tube
An old lava tube that is now empty. There are strange markings engraved into the shiny black rock walls. The wetlands are to the south and the volcano slope is to the west.

>x wall
The special goggles filter the markings on the wall, leaving only the faint scratches visible. You can clearly make out the number "133716" engraved in the wall. You pick up a leaf and scratch the number in with your fingernail. You put the leaf in your pocket.

>west
Volcano Slope
The slope of a towering active volcano in the middle of the island. The slope is covered with ash and underbrush. There is a small lava pit at the foot of the slope. The lava tube is to the east and the clearing is to the south.

A dreadful howl pierces the air. It sounds like it came from the Cave. Maybe you should stay away from whatever that was.

The creature is now at the Dirt Path.

>unlock hidden door with mysterious stone
You unlock the Hidden Door.

The creature is now at the Dirt Path.

>open hidden door
You open the Hidden Door.

The creature is now at the Dirt Path.

>n
Dark Tunnel
A dark tunnel dug under the slope of the volcano that looks to be man-made. The air is warm and the walls are lined with broken tunnel lights. Further down the tunnel, there are two large metal doors. One is to the north and one is to the east. There is an electronic keypad mounted on the wall between the two doors.

The creature is now at the Dirt Path.

>enter code
You enter the number "133716" into the electronic keypad. After a while, you hear a small beeping sound coming from both the north and east metal doors. As soon as the beeping stops, both doors slide open with a puff of white mist.

The creature is now at the Dirt Path.

>east
Secret Lab
A secret lab built under a volcano? Sounds like something straight out of a sci-fi movie! Flasks and beakers of different shapes and sizes line the shelves and tabletops. Rows of beeping machines are located in the far corner of the lab. The dark tunnel is to the east and the experiment room is to the north.

You can see an uncharged battery and a key card here.

You must supply a noun.

The creature is now at the Dirt Path.

>take battery
Taken.

The creature is now at the Dirt Path.

>take key card
Taken.

You must supply a noun.

The creature is now at the Dirt Path.

>north
Experiment Room
A dark room packed with empty animal pens and cages. Giant claw marks stretch across the blood-stained walls. There are three large cryo tubes sitting in the middle of the room. Next to one of the cryo tubes is a small sample safe. The underground cove is to the west and the secret lab is to the south.

You can see a sample safe (closed) here.

The creature is now at the Dirt Path.

>unlock sample safe with card
You unlock the sample safe.

The creature is now at the Dirt Path.

>take x
You can't see any such thing.

>open sample safe
You open the sample safe, revealing Vial x, Vial y and Vial z.

You must supply a noun.

The creature is now at the Dirt Path.

>take x
Taken.

The creature is now at the Dirt Path.

* * *

>take y
Taken.

The creature is now at the Dirt Path.

>mix x with y
You now have battery fluid.

You must supply a noun.

The creature is now at the Dirt Path.

>combine battery fluid with uncharged battery
You now have a charged battery.

The creature is now at the Dirt Path.

>west
Underground Cove
A hidden cove where the ocean flows underneath the volcano. This cove serves as a secret lab entrance for boats and other ocean vehicles. There is a small submarine floating in the water. The dark tunnel is to the south and the experiment room is to the east.

You can see a Broken submarine (empty) here.

You must supply a noun.

The creature is now at the Dirt Path.

>fix sub
You plug the charged battery into the empty space next to the engine. You climb into the submarine and start the engine. The propeller successfuly starts and you begin your descent away from the island. As you descend deeper, your surroundings slowly fade until you are engulfed in an empty white world.
 You open your eyes. Your eyesight is blurry and it takes a while for you to realize that you are staring straight up at a white ceiling. Still in a daze, you slowly sit up and look around. You realize that you're sitting on your bed in your bedroom. What an odd dream

    *** You have won ***

Would you like to RESTART, RESTORE a saved game, QUIT or UNDO the last command?

* * *

>take line
Taken.

>x hole
Quarter-sized holes that are scattered all around the shore line.

>n
Clearing
A wide open grassy clearing that is surrounded by a ring of palm trees. You can see a feeble lone tree in the center of the clearing and a cluster of boulders near the edge of the clearing. You can also see a mud pit near the boulders. Four paths from all directions intersect here. The volcano slope is to the north, the dirt path is to the west, the wetlands are to the east, and the beach is to the south.

>x boulders
A patch of large, black boulders. Most boulders are too large to move but there are other, smaller rocks scattered around.

You can see a sharp rock here.

* * *

>take rock
Taken.

>shake tree
You grab hold of the feeble trunk and shake it gently. A skinny branch detaches iteself from the trunk and falls to the ground. You take a closer look at the branch and see that it is actually a strong, flexible stick.

* * *

>take stick
Taken.

>x pit
A small pit filled with warm, thick mud.

You can see a worm on the surface of the mud.

>take worm
Taken.

>x pit
A small pit filled with warm, thick mud.

>combine stick with line
You tie the fishing line into a notch at the end of the stick. You have created an unfinished rod.

* * *

>take handle
Taken.

>break door
You have nothing to break the door with.

>cut door
You must supply a second noun.

>combine rock with handle
You shove the sharp rock into the wooden handle. You have created a stone axe.

>break door
What do you want to break the door with?

* * *

>break door with axe
You chop and break the wooden planks. You can now open the door.

>undo
Dirt Path
[Previous turn undone.]

>cut door
You must supply a second noun.

>cut door with axe
You chop and break the wooden planks. You can now open the door.

>open the door
You open the Wooden Door.

>n
Old Shack
A dark and musty shack. The walls are lined with shelves that hold misshapen skulls, flasks, and other unusual objects. How odd. The dirt path is to the south.

You can see a Scientist here.

* * *

>give scientist mullet
The scientist hungrily snatches the cooked mullet out of your hands.

>talk to scientist
Thank you so much, I was literally dying of starvation. Anyways, if you're trying to get off this island, there's a secret lab under the volcano to the north. Take this key to the locked gate to the west. You may find something useful in the cave. Also, take these goggles to the lava tube on the east side of the island. With these special goggles, You should be able to find the passcode to the lab. Unfortunately, that's all I rememberBe careful.

>i
You are carrying:
  a rusty key
  a special goggles
  a Stone axe
  a fishing rod

>s
Dirt Path
An old dirt path lined with greenery. There is a hut to the north and a gate to the west.

* * *

>w
The gate at the cave entrance is locked.

>unlock gate with key
You unlock the Gate.

>open gate
The gate opens with a loud creak that echoes through the dark cave. The creaking of the gate is followed by a distant growl from somewhere far inside the cave.

* * *

>l
Dirt Path
An old dirt path lined with greenery. There is a hut to the north and a gate to the west.

>i
You are carrying:
  a mysterious stone
  a special goggles
  a Stone axe
  a fishing rod

>wear goggles
You put on the special goggles.

* * *

>n
Lava Tube
An old lava tube that is now empty. There are strange markings engraved into the shiny black rock walls. The wetlands are to the south and the volcano slope is to the west.

>x wall
The special goggles filter the markings on the wall, leaving only the faint scratches visible. You can clearly make out the number "133716" engraved in the wall. You pick up a leaf and scratch the number in with your fingernail. You put the leaf in your pocket.

A dreadful howl pierces the air. It sounds like it came from the Cave. Maybe you should stay away from whatever that was.

The creature is now at the Dirt Path.

>i
You are carrying:
  a code
  a mysterious stone
  a special goggles (being worn)
  a Stone axe
  a fishing rod

A dreadful howl pierces the air. It sounds like it came from the Cave. Maybe you should stay away from whatever that was.

The creature is now at the Dirt Path.

>w
Volcano Slope
The slope of a towering active volcano in the middle of the island. The slope is covered with ash and underbrush. There is a small lava pit at the foot of the slope. The lava tube is to the east and the clearing is to the south.

The creature is now at the Dirt Path.

>x volcano
A towering volcano thats peak is hidden in the clouds. The underbrush covering the volcano looks a little strange.

The creature is now in the Clearing.

>e
Lava Tube
An old lava tube that is now empty. There are strange markings engraved into the shiny black rock walls. The wetlands are to the south and the volcano slope is to the west.

The creature is now at the Wetlands.

>w
Volcano Slope
The slope of a towering active volcano in the middle of the island. The slope is covered with ash and underbrush. There is a small lava pit at the foot of the slope. The lava tube is to the east and the clearing is to the south.

The creature is now at the Wetlands.

>x underbrush
Volcanic ferns and skinny trees that are rooted on the slope of the volcano. You notice a door built into the side of the volcano behind one of the ferns.

The creature is now at the Wetlands.

>x door
A hidden stone door placed under the underbrush on the volcano slope. In the middle of the door is an indent that is shaped like the front of a skull.

The creature is now at the Wetlands.

>x stone
Which do you mean, the mysterious stone or the Stone axe?

>mysterious stone
An odd-looking stone that resembles a human skull.

The creature is now in the Clearing.

>e
Lava Tube
An old lava tube that is now empty. There are strange markings engraved into the shiny black rock walls. The wetlands are to the south and the volcano slope is to the west.

The creature is now in the Clearing.

>x wall
Old cave paintings with the number "133716" etched in behind.

The creature is now at the Wetlands.

>w
Volcano Slope
The slope of a towering active volcano in the middle of the island. The slope is covered with ash and underbrush. There is a small lava pit at the foot of the slope. The lava tube is to the east and the clearing is to the south.

The creature is now in the Clearing.

>e
Lava Tube
An old lava tube that is now empty. There are strange markings engraved into the shiny black rock walls. The wetlands are to the south and the volcano slope is to the west.

The creature is now in the Clearing.

* * *

>x wall
Old cave paintings with the number "133716" etched in behind.

The creature is now at the Wetlands.

>w
Volcano Slope
The slope of a towering active volcano in the middle of the island. The slope is covered with ash and underbrush. There is a small lava pit at the foot of the slope. The lava tube is to the east and the clearing is to the south.

The creature is now at the Wetlands.

>unlock door with mysterious stone
You unlock the Hidden Door.

The creature is now at the Wetlands.

>open door
You open the Hidden Door.

The creature is now at the Wetlands.

>n
Dark Tunnel
A dark tunnel dug under the slope of the volcano that looks to be man-made. The air is warm and the walls are lined with broken tunnel lights. Further down the tunnel, there are two large metal doors. One is to the north and one is to the east. There is an electronic keypad mounted on the wall between the two doors.

You must supply a noun.

The creature is now at the Wetlands.

>x keypad
A small electric keypad located on the wall between the north and east lab doors. Located on the keypad are ten buttons: one for every number from 0-9.

The creature is now at the Wetlands.

>x doors
You can't see any such thing.

>x door
Which do you mean, the North Metal Door, the East Metal Door or the Hidden Door?

>north metal door
A metal door that slides open from the middle.

The creature is now at the Wetlands.

* * *

>x hole
Quarter-sized holes that are scattered all around the shore line.

>take key
Taken.

* * *

>w
The gate at the cave entrance is locked.

>unlock gate
(with the rusty key)
You unlock the Gate.

>open gate
The gate opens with a loud creak that echoes through the dark cave. The creaking of the gate is followed by a distant growl from somewhere far inside the cave.

* * *

>e
Clearing
A wide open grassy clearing that is surrounded by a ring of palm trees. You can see a feeble lone tree in the center of the clearing and a cluster of boulders near the edge of the clearing. You can also see a mud pit near the boulders. Four paths from all directions intersect here. The volcano slope is to the north, the dirt path is to the west, the wetlands are to the east, and the beach is to the south.

>w
Dirt Path
An old dirt path lined with greenery. There is a hut to the north and a gate to the west.

You can see a wooden handle here.

* * *

>take handle
Taken.

>e
Clearing
A wide open grassy clearing that is surrounded by a ring of palm trees. You can see a feeble lone tree in the center of the clearing and a cluster of boulders near the edge of the clearing. You can also see a mud pit near the boulders. Four paths from all directions intersect here. The volcano slope is to the north, the dirt path is to the west, the wetlands are to the east, and the beach is to the south.

>shake tree
You grab hold of the feeble trunk and shake it gently. A skinny branch detaches iteself from the trunk and falls to the ground. You take a closer look at the branch and see that it is actually a strong, flexible stick.

A dreadful howl pierces the air. It sounds like it came from the Cave. Maybe you should stay away from whatever that was.

The creature is now at the Dirt Path.

>take stone
You already have that.

The creature is now at the Dirt Path.

>take rock
Taken.

The creature arrives from the west.

The creature is now in the Clearing.

Fear strikes your heart as you lay eyes on the hideous creature staring back at you with four glaring eyes. This experiment gone wrong stands at twice your height. Its black fur is stained with the blood of its victims. Letting out a deathly howl, the creature lunges at you with its sickle claws outstretched and twisted fangs bared.

    *** you have been killed by the creature ***

Would you like to RESTART, RESTORE a saved game, QUIT or UNDO the last command?

* * *

>w
Cave
A dark and spacious cave that seems to extend much farther undergound. The only sound that can be heard here is the water droplets falling from the ceiling. The dirt path is to the east.

You can see a mysterious stone here.

* * *

>e
Wetlands
A series of small ponds surrounded by tall grass and mangrove plants. The lava tube is to the north and the clearing is to the west.

>n
Lava Tube
An old lava tube that is now empty. There are strange markings engraved into the shiny black rock walls.

A dreadful howl pierces the air. It sounds like it came from the Cave. Maybe you should stay away from whatever that was.

The creature is now at the Dirt Path.

>s
Wetlands
A series of small ponds surrounded by tall grass and mangrove plants. The lava tube is to the north and the clearing is to the west.

The creature is now at the Dirt Path.

>n
Lava Tube
An old lava tube that is now empty. There are strange markings engraved into the shiny black rock walls.

The creature is now at the Dirt Path.

>n
You can't go that way.

The creature is now at the Dirt Path.

>x wall
Cave paintings and hieroglyphs that look to have been engraved into the rock wall long ago. There are also some faint scratches that look out of place.

The creature is now in the Clearing.

>x wall
Cave paintings and hieroglyphs that look to have been engraved into the rock wall long ago. There are also some faint scratches that look out of place.

The creature is now in the Clearing.

>x wall
Cave paintings and hieroglyphs that look to have been engraved into the rock wall long ago. There are also some faint scratches that look out of place.

The creature is now at the Wetlands.

>x wall
Cave paintings and hieroglyphs that look to have been engraved into the rock wall long ago. There are also some faint scratches that look out of place.

The creature is now at the Wetlands.

>x wall
Cave paintings and hieroglyphs that look to have been engraved into the rock wall long ago. There are also some faint scratches that look out of place.

The creature arrives from the south.

The creature is now in the Lava Tube.

Fear strikes your heart as you lay eyes on the hideous creature staring back at you with four glaring eyes. This experiment gone wrong stands at twice your height. Its black fur is stained with the blood of its victims. Letting out a deathly howl, the creature lunges at you with its sickle claws outstretched and twisted fangs bared.

    *** you have been killed by the creature ***

Would you like to RESTART, RESTORE a saved game, QUIT or UNDO the last command?

* * *

>e
Wetlands
A series of small ponds surrounded by tall grass and mangrove plants. The lava tube is to the north and the clearing is to the west.

>e
You can't go that way.

>e
You can't go that way.

>e
You can't go that way.

A dreadful howl pierces the air. It sounds like it came from the Cave. Maybe you should stay away from whatever that was.

The creature is now at the Dirt Path.

>e
You can't go that way.

The creature is now at the Dirt Path.

>n
Lava Tube
An old lava tube that is now empty. There are strange markings engraved into the shiny black rock walls. The wetlands are to the south and the volcano slope is to the west.

The creature is now at the Dirt Path.

>n
You can't go that way.

The creature is now at the Dirt Path.

>n
You can't go that way.

The creature is now at the Dirt Path.

>n
You can't go that way.

The creature is now in the Clearing.

>n
You can't go that way.

The creature is now in the Clearing.

>n
You can't go that way.

The creature is now at the Wetlands.

>w
Volcano Slope
The slope of a towering active volcano in the middle of the island. The slope is covered with ash and underbrush. There is a small lava pit at the foot of the slope. The lava tube is to the east and the clearing is to the south.

The creature is now at the Wetlands.

>w
You can't go that way.

The creature is now at the Wetlands.

>w
You can't go that way.

The creature is now at the Wetlands.

>w
You can't go that way.

The creature is now in the Clearing.

>w
You can't go that way.

The creature arrives from the south.

The creature is now at the Volcano Slope.

Fear strikes your heart as you lay eyes on the hideous creature staring back at you with four glaring eyes. This experiment gone wrong stands at twice your height. Its black fur is stained with the blood of its victims. Letting out a deathly howl, the creature lunges at you with its sickle claws outstretched and twisted fangs bared.

    *** you have been killed by the creature ***

Would you like to RESTART, RESTORE a saved game, QUIT or UNDO the last command?

>undo
Volcano Slope
[Previous turn undone.]

* * *

>w
Dirt Path
An old dirt path lined with greenery. There is a hut to the north and a gate to the west.

You can see a wooden handle here.

>unlock gate with key
You unlock the Gate.

* * *

>take handle
Taken.

>l
Dirt Path
An old dirt path lined with greenery. There is a hut to the north and a gate to the west.

>n
The wooden door to the shack won't budge. It is locked with wooden planks that are nailed to the front of the door. Maybe you could somehow break them.

* * *

>e
Clearing
A wide open grassy clearing that is surrounded by a ring of palm trees. You can see a feeble lone tree in the center of the clearing and a cluster of boulders near the edge of the clearing. You can also see a mud pit near the boulders. Four paths from all directions intersect here. The volcano slope is to the north, the dirt path is to the west, the wetlands are to the east, and the beach is to the south.

>shake tree
You grab hold of the feeble trunk and shake it gently. A skinny branch detaches iteself from the trunk and falls to the ground. You take a closer look at the branch and see that it is actually a strong, flexible stick.

>take stick
Taken.

A dreadful howl pierces the air. It sounds like it came from the Cave. Maybe you should stay away from whatever that was.

The creature is now at the Dirt Path.

>x boulder
A patch of large, black boulders. Most boulders are too large to move but there are other, smaller rocks scattered around.

You can see a sharp rock here.

The creature arrives from the west.

The creature is now in the Clearing.

Fear strikes your heart as you lay eyes on the hideous creature staring back at you with four glaring eyes. This experiment gone wrong stands at twice your height. Its black fur is stained with the blood of its victims. Letting out a deathly howl, the creature lunges at you with its sickle claws outstretched and twisted fangs bared.

    *** you have been killed by the creature ***

Would you like to RESTART, RESTORE a saved game, QUIT or UNDO the last command?

* * *

>w
Dirt Path
An old dirt path lined with greenery. There is a hut to the north and a gate to the west.

You can see a wooden handle here.

>w
Cave
A dark and spacious cave that seems to extend much farther undergound. The only sound that can be heard here is the water droplets falling from the ceiling. The dirt path is to the east.

You can see a mysterious stone here.

* * *

>take stone
Taken.

>e
A dreadful howl pierces the air. It sounds like it came from the Cave. Maybe you should stay away from whatever that was.

The creature is now at the Dirt Path.

Fear strikes your heart as you lay eyes on the hideous creature staring back at you with four glaring eyes. This experiment gone wrong stands at twice your height. Its black fur is stained with the blood of its victims. Letting out a deathly howl, the creature lunges at you with its sickle claws outstretched and twisted fangs bared.

    *** you have been killed by the creature ***

Would you like to RESTART, RESTORE a saved game, QUIT or UNDO the last command?

>undo
Cave
[Previous turn undone.]

>w
You can't go that way.

A dreadful howl pierces the air. It sounds like it came from the Cave. Maybe you should stay away from whatever that was.

The creature is now at the Dirt Path.

>w
You can't go that way.

The creature is now at the Dirt Path.

>w
You can't go that way.

The creature is now at the Dirt Path.

>w
You can't go that way.

You must supply a noun.

The creature is now at the Dirt Path.

>w
You can't go that way.

The creature is now at the Dirt Path.

* * *

>w
You can't go that way.

You must supply a noun.

The creature is now at the Dirt Path.

I beg your pardon?

>w
You can't go that way.

You must supply a noun.

The creature is now at the Dirt Path.

>w
You can't go that way.

You must supply a noun.

The creature is now at the Dirt Path.

* * *

I beg your pardon?

I beg your pardon?

>w
You can't go that way.

The creature is now at the Dirt Path.

* * *

>e
Wetlands
A series of small ponds surrounded by tall grass and mangrove plants. The lava tube is to the north and the clearing is to the west.

>e
You can't go that way.

A dreadful howl pierces the air. It sounds like it came from the Cave. Maybe you should stay away from whatever that was.

The creature is now in the Cave.

>w
Clearing
A wide open grassy clearing that is surrounded by a ring of palm trees. You can see a feeble lone tree in the center of the clearing and a cluster of boulders near the edge of the clearing. You can also see a mud pit near the boulders. Four paths from all directions intersect here. The volcano slope is to the north, the dirt path is to the west, the wetlands are to the east, and the beach is to the south.

The creature is now in the Cave.

>e
Wetlands
A series of small ponds surrounded by tall grass and mangrove plants. The lava tube is to the north and the clearing is to the west.

The creature is now in the Cave.

>e
You can't go that way.

The creature is now in the Cave.

>e
You can't go that way.

The creature is now in the Cave.

>w
Clearing
A wide open grassy clearing that is surrounded by a ring of palm trees. You can see a feeble lone tree in the center of the clearing and a cluster of boulders near the edge of the clearing. You can also see a mud pit near the boulders. Four paths from all directions intersect here. The volcano slope is to the north, the dirt path is to the west, the wetlands are to the east, and the beach is to the south.

You must supply a noun.

The creature is now in the Cave.

>e
Wetlands
A series of small ponds surrounded by tall grass and mangrove plants. The lava tube is to the north and the clearing is to the west.

The creature is now in the Cave.

>w
Clearing
A wide open grassy clearing that is surrounded by a ring of palm trees. You can see a feeble lone tree in the center of the clearing and a cluster of boulders near the edge of the clearing. You can also see a mud pit near the boulders. Four paths from all directions intersect here. The volcano slope is to the north, the dirt path is to the west, the wetlands are to the east, and the beach is to the south.

You must supply a noun.

The creature is now in the Cave.

>e
Wetlands
A series of small ponds surrounded by tall grass and mangrove plants. The lava tube is to the north and the clearing is to the west.

You must supply a noun.

The creature is now in the Cave.

>w
Clearing
A wide open grassy clearing that is surrounded by a ring of palm trees. You can see a feeble lone tree in the center of the clearing and a cluster of boulders near the edge of the clearing. You can also see a mud pit near the boulders. Four paths from all directions intersect here. The volcano slope is to the north, the dirt path is to the west, the wetlands are to the east, and the beach is to the south.

The creature is now in the Cave.

* * *

>e
Wetlands
A series of small ponds surrounded by tall grass and mangrove plants. The lava tube is to the north and the clearing is to the west.

The creature is now in the Cave.

>w
Clearing
A wide open grassy clearing that is surrounded by a ring of palm trees. You can see a feeble lone tree in the center of the clearing and a cluster of boulders near the edge of the clearing. You can also see a mud pit near the boulders. Four paths from all directions intersect here. The volcano slope is to the north, the dirt path is to the west, the wetlands are to the east, and the beach is to the south.

The creature is now in the Cave.

>w
Dirt Path
An old dirt path lined with greenery. There is a hut to the north and a gate to the west.

You can see a wooden handle here.

The creature is now in the Cave.

* * *

>w
Dirt Path
An old dirt path lined with greenery. There is a hut to the north and a gate to the west.

You can see a wooden handle here.

>e
Clearing
A wide open grassy clearing that is surrounded by a ring of palm trees. You can see a feeble lone tree in the center of the clearing and a cluster of boulders near the edge of the clearing. You can also see a mud pit near the boulders. Four paths from all directions intersect here. The volcano slope is to the north, the dirt path is to the west, the wetlands are to the east, and the beach is to the south.

A dreadful howl pierces the air. It sounds like it came from the Cave. Maybe you should stay away from whatever that was.

The creature is now in the Cave.

>e
Wetlands
A series of small ponds surrounded by tall grass and mangrove plants. The lava tube is to the north and the clearing is to the west.

The creature is now in the Cave.

>n
Lava Tube
An old lava tube that is now empty. There are strange markings engraved into the shiny black rock walls.

The creature is now in the Cave.

>s
Wetlands
A series of small ponds surrounded by tall grass and mangrove plants. The lava tube is to the north and the clearing is to the west.

The creature is now in the Cave.

>s
You can't go that way.

You must supply a noun.

The creature is now in the Cave.

>ss
That's not a verb I recognise.

>s
You can't go that way.

The creature is now in the Cave.

>x pond
A small pond that is connected to a river flowing from the north, and the ocean to the south. This pond is home to many fish.

The creature is now in the Cave.

>x pond
A small pond that is connected to a river flowing from the north, and the ocean to the south. This pond is home to many fish.

The creature is now in the Cave.

>x pond
A small pond that is connected to a river flowing from the north, and the ocean to the south. This pond is home to many fish.

You must supply a noun.

The creature is now in the Cave.

>x pond
A small pond that is connected to a river flowing from the north, and the ocean to the south. This pond is home to many fish.

The creature is now in the Cave.

* * *

>x hole
Quarter-sized holes that are scattered all around the shore line.

>take line
Taken.

* * *

>n
Clearing
A wide open grassy clearing that is surrounded by a ring of palm trees. You can see a feeble lone tree in the center of the clearing and a cluster of boulders near the edge of the clearing. You can also see a mud pit near the boulders. Four paths from all directions intersect here. The volcano slope is to the north, the dirt path is to the west, the wetlands are to the east, and the beach is to the south.

>i
You are carrying:
  a thin line

>shake tree
You grab hold of the feeble trunk and shake it gently. A skinny branch detaches iteself from the trunk and falls to the ground. You take a closer look at the branch and see that it is actually a strong, flexible stick.

>take rock
Taken.

>x boulders
A patch of large, black boulders. Most boulders are too large to move but there are other, smaller rocks scattered around.

>x pit
A small pit filled with warm, thick mud.

You can see a worm on the surface of the mud.

* * *

>take worm
Taken.

>combine stick with line
(first taking the flexible stick)
You tie the fishing line into a notch at the end of the stick. You have created an unfinished rod.

* * *

>fish
(in the small ponds)
You throw your line in the pond and wait for a bite. It's not long until you feel something tugging on your line. You pull in your line and take the raw mullet on the end.

>i
You are carrying:
  a raw mullet
  a fishing rod
  a sharp rock

>w
Clearing
A wide open grassy clearing that is surrounded by a ring of palm trees. You can see a feeble lone tree in the center of the clearing and a cluster of boulders near the edge of the clearing. You can also see a mud pit near the boulders. Four paths from all directions intersect here. The volcano slope is to the north, the dirt path is to the west, the wetlands are to the east, and the beach is to the south.

* * *

>take handle
Taken.

>n
The wooden door to the shack won't budge. It is locked with wooden planks that are nailed to the front of the door. Maybe you could somehow break them.

>combine handle with rock
You shove the sharp rock into the wooden handle. You have created a stone axe.

* * *

>break door
What do you want to break the door with?

>break door
What do you want to break the door with?

>cut door
You must supply a second noun.

>chop planks
You must supply a second noun.

>break door with axe
You chop and break the wooden planks. You can now open the door.

* * *

>touch sand
very fine and warm.

>n
Clearing
A wide open grassy clearing that is surrounded by a ring of palm trees. You can see a feeble lone tree in the center of the clearing and a cluster of boulders near the edge of the clearing. You can also see a mud pit near the boulders. Four paths from all directions intersect here. The volcano slope is to the north, the dirt path is to the west, the wetlands are to the east, and the beach is to the south.

>touch tree
You feel nothing unexpected.

* * *

>n
Clearing
A wide open grassy clearing that is surrounded by a ring of palm trees. You can see a feeble lone tree in the center of the clearing and a cluster of boulders near the edge of the clearing. You can also see a mud pit near the boulders. Four paths from all directions intersect here. The volcano slope is to the north, the dirt path is to the west, the wetlands are to the east, and the beach is to the south.

>touch rock
ouch!

* * *

>n
Clearing
A wide open grassy clearing that is surrounded by a ring of palm trees. You can see a feeble lone tree in the center of the clearing and a cluster of boulders near the edge of the clearing. You can also see a mud pit near the boulders. Four paths from all directions intersect here. The volcano slope is to the north, the dirt path is to the west, the wetlands are to the east, and the beach is to the south.

>touch worm
squishy.

>take worm
Taken.

* * *

>n
Clearing
A wide open grassy clearing that is surrounded by a ring of palm trees. You can see a feeble lone tree in the center of the clearing and a cluster of boulders near the edge of the clearing. You can also see a mud pit near the boulders. Four paths from all directions intersect here. The volcano slope is to the north, the dirt path is to the west, the wetlands are to the east, and the beach is to the south.

>e
Wetlands
A series of small ponds surrounded by tall grass and mangrove plants. The lava tube is to the north and the clearing is to the west.

* * *

>n
Lava Tube
An old lava tube that is now empty. There are strange markings engraved into the shiny black rock walls. The wetlands are to the south and the volcano slope is to the west.

>x wall
Cave paintings and hieroglyphs that look to have been engraved into the rock wall long ago. There are also some faint scratches that look out of place.

>touch wall
You can feel tiny, man-made scratches behind the paintings.

* * *

>w
Dirt Path
An old dirt path lined with greenery. There is a hut to the north and a gate to the west.

You can see a wooden handle here.

I beg your pardon?

* * *

>touch line
You feel nothing unexpected.

>touch sand
You feel nothing unexpected.