You open your eyes. Your eyesight is blurry and it takes a while for you to realize that you are staring straight up at the cloudless blue sky. The faint squawk of birds slowly gets louder as you come back to your senses.  Still in a daze, you slowly sit up and look around. You find yourself sitting on the soft white sand of an empty beach. How in the world did you end up here? Your clothes is tattered and your entire body aches with pain. Carefully, you stand up and walk around, letting the warm sand slip through your bare toes. After examining your surroundings a bit more, you realize that you're on a small Island.

Jungle Terror
An Interactive Fiction by Braden Yoshinaga
Release 1 / Serial number 140307 / Inform 7 build 6G60 (I6/v6.32 lib 6/12N) SD

Beach
A beautiful white sand beach that stretches around the entire island. Waves from the vast, sapphire ocean gently lap the shore. The sand here is littered with many crab holes. Palm trees line the dirt farther north up the beach.

You can see a thin line here.

>x thin line
A long, tough fishing line that washed up on the beach.

* * *

>take line
Taken.

>x palm trees
Tall, slender palms that lazily sway in the breeze.

>n
Clearing
A wide open grassy clearing that is surrounded by a ring of palm trees. You can see a feeble lone tree in the center of the clearing and a cluster of boulders near the edge of the clearing. You can also see a mud pit near the boulders. Four paths from all directions intersect here.

>x boulders
A patch of large, black boulders. Most boulders are too large to move but there are other, smaller rocks scattered around.

You can see a sharp rock here.

>take sharp rock
Taken.

>x sharp rock
A rock with one sharp, serrated side that resembles a blade edge.

>x mud
A small pit filled with warm, thick mud.

You can see a worm on the surface of the mud.

>x worm
A plump and juicy pink worm.

>take worm
Taken.

>eat worm
That's plainly inedible.

>x clearing
You can't see any such thing.

>l
Clearing
A wide open grassy clearing that is surrounded by a ring of palm trees. You can see a feeble lone tree in the center of the clearing and a cluster of boulders near the edge of the clearing. You can also see a mud pit near the boulders. Four paths from all directions intersect here.

>x lone tree
A lonely tree that sits in the middle of the clearing. Its trunk is tall and feeble. Its leafless branches sadly slump towards the dirt.

High above you, way out of reach, you see skinny branches dangling from the weak trunk. Maybe you can somehow get one.

>west
Dirt path
An old dirt path lined with greenery. There is a hut to the north and a cave entrance to the west.

You can see a wooden handle here.

>x handle
A curved piece of wood that resembles the handle of an axe.

>take handle
Taken.

>combine handle with sharp rock
You now have a Stone axe.

>i
You are carrying:
  a Stone axe
  a worm
  a thin line

>x hut
A round and old wooden shack with a pointed straw roof. The walls of the shack are lined with giant scratches that look like claw marks.

>x scratches
You can't see any such thing.

>north
The wooden door to the hut won't budge. It is locked with wooden planks that are nailed to the front of the door. Maybe you could somehow break them.

>break door with axe
You can't see any such thing.

>break wooden door with axe
You can't see any such thing.

>break door with stone axe
You can't see any such thing.

>break planks with stone axe
You can't see any such thing.

>chop wooden door
You chop and break the wooden planks. You can now open the door.

>undo
Dirt path
[Previous turn undone.]

* * *

>n
Clearing
A wide open grassy clearing that is surrounded by a ring of palm trees. You can see a feeble lone tree in the center of the clearing and a cluster of boulders near the edge of the clearing. You can also see a mud pit near the boulders. Four paths from all directions intersect here.

>take stone
You can't see any such thing.

* * *

>take rock
Taken.

>e
Wetlands
A series of small ponds surrounded by tall grass and mangrove roots. A lava tube is to the north.

>w
Clearing
A wide open grassy clearing that is surrounded by a ring of palm trees. You can see a feeble lone tree in the center of the clearing and a cluster of boulders near the edge of the clearing. You can also see a mud pit near the boulders. Four paths from all directions intersect here.

>w
Dirt path
An old dirt path lined with greenery. There is a hut to the north and a cave entrance to the west.

You can see a wooden handle here.

* * *

>take handle
Taken.

>combine handle and rock
You can't use multiple objects with that verb.

>n
The wooden door to the hut won't budge. It is locked with wooden planks that are nailed to the front of the door. Maybe you could somehow break them.

>combine handle with rock
You now have a Stone axe.

>n
The wooden door to the hut won't budge. It is locked with wooden planks that are nailed to the front of the door. Maybe you could somehow break them.

>break planks
You chop and break the wooden planks. You can now open the door.

* * *

>n
Old shack
A dark and musty shack. The walls are lined with shelves that hold misshapen skulls, flasks, and other unusual objects. How odd.

You can see a Scientist here.

>e
You can't go that way.

I beg your pardon?

>s
Dirt path
An old dirt path lined with greenery. There is a hut to the north and a cave entrance to the west.

* * *

>w
The gate is locked.

>e
Clearing
A wide open grassy clearing that is surrounded by a ring of palm trees. You can see a feeble lone tree in the center of the clearing and a cluster of boulders near the edge of the clearing. You can also see a mud pit near the boulders. Four paths from all directions intersect here.

* * *

>e
Wetlands
A series of small ponds surrounded by tall grass and mangrove roots. A lava tube is to the north.

>e
You can't go that way.

>n
Lava tube
An old lava tube that is now empty. There are strange markings engraved into the shiny black rock walls.

>w
Volcano Slope
The slope of a towering active volcano in the middle of the island. The slope is covered with ash and underbrush. There is a small lava pit at the foot of the slope.

>s
Clearing
A wide open grassy clearing that is surrounded by a ring of palm trees. You can see a feeble lone tree in the center of the clearing and a cluster of boulders near the edge of the clearing. You can also see a mud pit near the boulders. Four paths from all directions intersect here.

>take worm
Taken.

>s
Beach
A beautiful white sand beach that stretches around the entire island. Waves from the vast, sapphire ocean gently lap the shore. The sand here is littered with many crab holes. Palm trees line the dirt farther north up the beach.

You can see a thin line here.

>take line
Taken.

>n
Clearing
A wide open grassy clearing that is surrounded by a ring of palm trees. You can see a feeble lone tree in the center of the clearing and a cluster of boulders near the edge of the clearing. You can also see a mud pit near the boulders. Four paths from all directions intersect here.

* * *

>take stick
Taken.

>combine stick with line
You now have a tied stick.

* * *

>fish in pond
You throw your line in the pond and wait for a bite. It's not long until you feel something tugging on your line. You pull in your line and see a baby mullet on the end.

>take mullet
Taken.

>x mullet
A baby mullet that you caught in a pond. Maybe you can cook it somehow.

>i
You are carrying:
  a raw mullet
  a fishing rod
  a Stone axe

>w
Clearing
A wide open grassy clearing that is surrounded by a ring of palm trees. You can see a feeble lone tree in the center of the clearing and a cluster of boulders near the edge of the clearing. You can also see a mud pit near the boulders. Four paths from all directions intersect here.

* * *

>n
Volcano Slope
The slope of a towering active volcano in the middle of the island. The slope is covered with ash and underbrush. There is a small lava pit at the foot of the slope.

>cook mullet in pit
You carefully hold the raw mullet over the fire pit. After a while, the mullet cooks and becomes brown and crispy.

>cook mullet
(in the small lava pit)

* * *

>i
You are carrying:
  a fillet
  a fishing rod
  a Stone axe

>s
Clearing
A wide open grassy clearing that is surrounded by a ring of palm trees. You can see a feeble lone tree in the center of the clearing and a cluster of boulders near the edge of the clearing. You can also see a mud pit near the boulders. Four paths from all directions intersect here.

>w
Dirt path
An old dirt path lined with greenery. There is a hut to the north and a cave entrance to the west.

>n
Old shack
A dark and musty shack. The walls are lined with shelves that hold misshapen skulls, flasks, and other unusual objects. How odd.

You can see a Scientist here.

>give mullet to scientist
You can't see any such thing.

>i
You are carrying:
  a fillet
  a fishing rod
  a Stone axe

>give fillet to scientist
The scientist hungrily snatches the fillet out of your hands.

>talk to scientist
Thank you so much, I was literally dying of starvation. Anyways, if you're trying to get off this island, there's a secret lab under the volcano to the north. Take these goggles to the lava tube on the east side of the island. With these special goggles, You should be able to find the passcode to the lab. Unfortunately, that's all I remember…Be careful.er慷獹

>i
You are carrying:
  a special goggles
  a fishing rod
  a Stone axe

>s
Dirt path
An old dirt path lined with greenery. There is a hut to the north and a cave entrance to the west.

* * *

>w
The gate is locked.

>w
The gate is locked.

>n
Old shack
A dark and musty shack. The walls are lined with shelves that hold misshapen skulls, flasks, and other unusual objects. How odd.

You can see a Scientist here.

* * *

>e
You can't go that way.

>s
Dirt path
An old dirt path lined with greenery. There is a hut to the north and a cave entrance to the west.

>e
Clearing
A wide open grassy clearing that is surrounded by a ring of palm trees. You can see a feeble lone tree in the center of the clearing and a cluster of boulders near the edge of the clearing. You can also see a mud pit near the boulders. Four paths from all directions intersect here.

* * *

>wear goggles
You put on the special goggles.

>i
You are carrying:
  a special goggles (being worn)
  a fishing rod
  a Stone axe

>x markings
The special goggles filter the markings on the wall, leaving only the faint scratches visible. You can clearly make out the number "133716" engraved in the wall. You pick up a leaf and scratch in the number in with your fingernail.

>i
You are carrying:
  a code
  a special goggles (being worn)
  a fishing rod
  a Stone axe

>x paintings
Old cave paintings with the number "133716" etched in behind.

>x markings
Old cave paintings with the number "133716" etched in behind.

>x paintings
Old cave paintings with the number "133716" etched in behind.

>drop code
Dropped.

>x paintings
The special goggles filter the markings on the wall, leaving only the faint scratches visible. You can clearly make out the number "133716" engraved in the wall. You pick up a leaf and scratch in the number in with your fingernail.

>i
You are carrying:
  a code
  a special goggles (being worn)
  a fishing rod
  a Stone axe

>take code
You already have that.

>drop code
Dropped.

>remove goggles
You take off the special goggles.

>x paintings
Cave paintings and hieroglyphs that look to have been engraved into the rock wall long ago. There are also some faint scratches that look out of place.

>wear goggles
You put on the special goggles.

>take code
Taken.

* * *

>n
Clearing
A wide open grassy clearing that is surrounded by a ring of palm trees. You can see a feeble lone tree in the center of the clearing and a cluster of boulders near the edge of the clearing. You can also see a mud pit near the boulders. Four paths from all directions intersect here.

>take rock
Taken.

>w
Dirt path
An old dirt path lined with greenery. There is a hut to the north and a cave entrance to the west.

You can see a wooden handle here.

* * *

>combine handle with rock
You now have a Stone axe.

>cut door
You chop and break the wooden planks. You can now open the door.

>open door
You open the wooden door.

* * *

>n
Old shack
A dark and musty shack. The walls are lined with shelves that hold misshapen skulls, flasks, and other unusual objects. How odd.

You can see a Scientist here.

>talk to scientist
Food…please…

* * *

>n
Clearing
A wide open grassy clearing that is surrounded by a ring of palm trees. You can see a feeble lone tree in the center of the clearing and a cluster of boulders near the edge of the clearing. You can also see a mud pit near the boulders. Four paths from all directions intersect here.

>x pit
A small pit of warm, thick mud.

You can see a worm on the surface of the mud.

>n
Volcano Slope
The slope of a towering active volcano in the middle of the island. The slope is covered with ash and underbrush. There is a small lava pit at the foot of the slope.

>x pit
A pit filled with molten hot lava. The heat emitted from the pit feels like the heat of a stove.

* * *

>n
Clearing
A wide open grassy clearing that is surrounded by a ring of palm trees. You can see a feeble lone tree in the center of the clearing and a cluster of boulders near the edge of the clearing. You can also see a mud pit near the boulders. Four paths from all directions intersect here.

>take cooked fish
You can't see any such thing.

>take rock
Taken.

* * *

>take handle
Taken.

>combine rock with handle
You now have a Stone axe.

>break planks
You chop and break the wooden planks. You can now open the door.

* * *

>n
Old shack
A dark and musty shack. The walls are lined with shelves that hold misshapen skulls, flasks, and other unusual objects. How odd.

You can see a Scientist here.

>x scientist
A scientist?? What are the chances of finding a scientist on a stranded island?? How odd. The scientist is dressed in a ripped white lab coat and tattered black pants.

* * *

>n
Clearing
A wide open grassy clearing that is surrounded by a ring of palm trees. You can see a feeble lone tree in the center of the clearing and a cluster of boulders near the edge of the clearing. You can also see a mud pit near the boulders. Four paths from all directions intersect here.

>n
Volcano Slope
The slope of a towering active volcano in the middle of the island. The slope is covered with ash and underbrush. There is a small lava pit at the foot of the slope.

>cook mullet in lava pit
You can't see any such thing.

* * *

>n
Clearing
A wide open grassy clearing that is surrounded by a ring of palm trees. You can see a feeble lone tree in the center of the clearing and a cluster of boulders near the edge of the clearing. You can also see a mud pit near the boulders. Four paths from all directions intersect here.

>e
Wetlands
A series of small ponds surrounded by tall grass and mangrove roots. A lava tube is to the north.

* * *

>n
Lava tube
An old lava tube that is now empty. There are strange markings engraved into the shiny black rock walls.

>x markings
Cave paintings and hieroglyphs that look to have been engraved into the rock wall long ago. There are also some faint scratches that look out of place.

>x paintings
You can't see any such thing.

* * *

>e
Wetlands
A series of small ponds surrounded by tall grass and mangrove roots. A lava tube is to the north.

>fish in pond
You don't have anything to fish with.

>fish in pond
You don't have anything to fish with.

>w
Clearing
A wide open grassy clearing that is surrounded by a ring of palm trees. You can see a feeble lone tree in the center of the clearing and a cluster of boulders near the edge of the clearing. You can also see a mud pit near the boulders. Four paths from all directions intersect here.

>shake tree
You grab hold of the feeble trunk and shake it violently. A skinny branch detaches iteself from the trunk and falls to the ground. You take a closer look at the branch and see that it is actually a strong, flexible stick.

* * *

>take line
Taken.

>combine line with stick
You now have a tied stick.

>combine stick with worm
You now have a fishing rod.

>n
Clearing
A wide open grassy clearing that is surrounded by a ring of palm trees. You can see a feeble lone tree in the center of the clearing and a cluster of boulders near the edge of the clearing. You can also see a mud pit near the boulders. Four paths from all directions intersect here.

>e
Wetlands
A series of small ponds surrounded by tall grass and mangrove roots.

>fish in pond
You throw your line in the pond and wait for a bite. It's not long until you feel something tugging on your line. You pull in your line and see a baby mullet on the end.

>x mullet
You see nothing special about the mullet.

>fish in small ponds
You throw your line in the pond and wait for a bite. It's not long until you feel something tugging on your line. You pull in your line and see a baby mullet on the end.

>fish in small pond
You throw your line in the pond and wait for a bite. It's not long until you feel something tugging on your line. You pull in your line and see a baby mullet on the end.

>fish in the pond
You throw your line in the pond and wait for a bite. It's not long until you feel something tugging on your line. You pull in your line and see a baby mullet on the end.

>fish in the small pond
You throw your line in the pond and wait for a bite. It's not long until you feel something tugging on your line. You pull in your line and see a baby mullet on the end.

>thrust in small pond
That's not a verb I recognise.

>thrust in pond
That's not a verb I recognise.

>fish in pond
You throw your line in the pond and wait for a bite. It's not long until you feel something tugging on your line. You pull in your line and see a baby mullet on the end.

>fish the small pond
I didn't understand that sentence.

>fish in pond
You throw your line in the pond and wait for a bite. It's not long until you feel something tugging on your line. You pull in your line and see a baby mullet on the end.

>fish in pond
You throw your line in the pond and wait for a bite. It's not long until you feel something tugging on your line. You pull in your line and see a baby mullet on the end.

>fish in the small pond
You throw your line in the pond and wait for a bite. It's not long until you feel something tugging on your line. You pull in your line and see a baby mullet on the end.

>fish in the small pond
You throw your line in the pond and wait for a bite. It's not long until you feel something tugging on your line. You pull in your line and see a baby mullet on the end.

>i
You are carrying:
  a fishing rod

>fishing in the small ponds
That's not a verb I recognise.

>spear the pond
That's not a verb I recognise.

>spear the pond
That's not a verb I recognise.

>fish in pond
You throw your line in the pond and wait for a bite. It's not long until you feel something tugging on your line. You pull in your line and see a baby mullet on the end.

* * *

>take mullet
Taken.

>i
You are carrying:
  a mullet
  a fishing rod

>x mullet
You see nothing special about the mullet.

>fish in pond
You already have a fish!

>x
What do you want to examine?

* * *

>x mullet
You can't see any such thing.

>break pond
Violence isn't the answer to this one.

>fish pond
I didn't understand that sentence.

* * *

>n
Clearing
A wide open grassy clearing that is surrounded by a ring of palm trees. You can see a feeble lone tree in the center of the clearing and a cluster of boulders near the edge of the clearing. You can also see a mud pit near the boulders. Four paths from all directions intersect here.

>s
Beach
A beautiful white sand beach that stretches around the entire island. Waves from the vast, sapphire ocean gently lap the shore. The sand here is littered with many crab holes. Palm trees line the dirt farther north up the beach.

You can see a thin line here.

>take key
You can't see any such thing.

>n
Clearing
A wide open grassy clearing that is surrounded by a ring of palm trees. You can see a feeble lone tree in the center of the clearing and a cluster of boulders near the edge of the clearing. You can also see a mud pit near the boulders. Four paths from all directions intersect here.

* * *

>s
Beach
A beautiful white sand beach that stretches around the entire island. Waves from the vast, sapphire ocean gently lap the shore. The sand here is littered with many crab holes. Palm trees line the dirt farther north up the beach.

You can see a thin line here.

>x hold
You can't see any such thing.

>x hole
Quarter-sized holes that are scattered all around the shore line.

Something shiny catches your eye in one of the holes near your feet. You take a closer look and see that it's a rusty key.

* * *

>n
Clearing
A wide open grassy clearing that is surrounded by a ring of palm trees. You can see a feeble lone tree in the center of the clearing and a cluster of boulders near the edge of the clearing. You can also see a mud pit near the boulders. Four paths from all directions intersect here.

>w
Dirt path
An old dirt path lined with greenery. There is a hut to the north and a cave entrance to the west.

You can see a wooden handle here.

>w
The gate is locked.

>unlock gate
(with the rusty key)
You unlock the gate.

>open gate
You open the gate.

* * *

>w
cave entrance
A dark and gaping cave entrance. The entire mouth of the cave has been blocked by a locked gate. The gate is littered with warning and danger signs. How eerie…

You can see a mysterious stone here.

>take stone
Taken.

>e
Dirt path
An old dirt path lined with greenery. There is a hut to the north and a cave entrance to the west.

You can see a wooden handle here.

>e
Clearing
A wide open grassy clearing that is surrounded by a ring of palm trees. You can see a feeble lone tree in the center of the clearing and a cluster of boulders near the edge of the clearing. You can also see a mud pit near the boulders. Four paths from all directions intersect here.

>n
Volcano Slope
The slope of a towering active volcano in the middle of the island. The slope is covered with ash and underbrush. There is a small lava pit at the foot of the slope.

>place stone in door
I didn't understand that sentence.

>place mysterious stone in hidden door
You place the mysterious stone in the indent on the hidden door. The stone fits perfectly and you can hear a far away clicking noise.

>open door
You open the hidden door.

>n
dark tunnel
A dark tunnel dug under the slope of the volcano that looks to be man-made. The air is warm and the walls are lined with broken tunnel lights.

>i
You are carrying:
  a mysterious stone
  a rusty key

>s
Volcano Slope
The slope of a towering active volcano in the middle of the island. The slope is covered with ash and underbrush. There is a small lava pit at the foot of the slope.

>drop stone
Dropped.

>place stone in indent
I didn't understand that sentence.

>place mysterious stone in indent
I didn't understand that sentence.

>place mysterious stone in hidden door
You have nothing to place in the door.

* * *

>take line
Taken.

>x line
A long, tough fishing line that washed up on the beach.

>n
Clearing
A wide open grassy clearing that is surrounded by a ring of palm trees. You can see a feeble lone tree in the center of the clearing and a cluster of boulders near the edge of the clearing. You can also see a mud pit near the boulders. Four paths from all directions intersect here.

* * *

>combine stick with line
You now have a tied stick.

>i
You are carrying:
  a tied stick

>x tied stick
A close resemblance to a fishing rod. All you need is bait.

>take worm
Taken.

>combine tied stick with bait
You can't see any such thing.

>combine tied stick with worm
You now have a fishing rod.

>e
Wetlands
A series of small ponds surrounded by tall grass and mangrove roots.

>x ponds
A small pond that is connected to a river flowing from the north, and the ocean to the south. This pond is home to many fish.

* * *

>s
Beach
A beautiful white sand beach that stretches around the entire island. Waves from the vast, sapphire ocean gently lap the shore. The sand here is littered with many crab holes. Palm trees line the dirt farther north up the beach.

You can see a thin line here.

>x hole
Quarter-sized holes that are scattered all around the shore line.

Something shiny catches your eye in one of the holes near your feet. You take a closer look and see that it's a rusty key.

>ake key
That's not a verb I recognise.

>n
Clearing
A wide open grassy clearing that is surrounded by a ring of palm trees. You can see a feeble lone tree in the center of the clearing and a cluster of boulders near the edge of the clearing. You can also see a mud pit near the boulders. Four paths from all directions intersect here.

* * *

>e
Clearing
A wide open grassy clearing that is surrounded by a ring of palm trees. You can see a feeble lone tree in the center of the clearing and a cluster of boulders near the edge of the clearing. You can also see a mud pit near the boulders. Four paths from all directions intersect here.

>s
Beach
A beautiful white sand beach that stretches around the entire island. Waves from the vast, sapphire ocean gently lap the shore. The sand here is littered with many crab holes. Palm trees line the dirt farther north up the beach.

You can see a rusty key and a thin line here.

>take key
Taken.

* * *

>n
Volcano Slope
The slope of a towering active volcano in the middle of the island. The slope is covered with ash and underbrush. There is a small lava pit at the foot of the slope.

>n
The hidden door is locked.

>unlock hidden door
What do you want to unlock the hidden door with?

>stone
You unlock the hidden door.

>open door
You open the hidden door.

* * *

>n
dark tunnel
A dark tunnel dug under the slope of the volcano that looks to be man-made. The air is warm and the walls are lined with broken tunnel lights. Furthur down the tunnel, there are two large metal doors. One is to the north and one is to the east. There is an electronic keypad mounted on the wall between the two doors.

>n
(first opening the north lab door)
It seems to be locked.

* * *

>x hole
Quarter-sized holes that are scattered all around the shore line.

Something shiny catches your eye in one of the holes near your feet. You take a closer look and see that it's a rusty key.

* * *

>open gate
You open the gate.

I beg your pardon?

>w
cave entrance
A dark and gaping cave entrance. The entire mouth of the cave has been blocked by a locked gate. The gate is littered with warning and danger signs. How eerie…

You can see a mysterious stone here.

* * *

>e
Dirt path
An old dirt path lined with greenery. There is a hut to the north and a cave entrance to the west.

You can see a wooden handle here.

I beg your pardon?

>e
Clearing
A wide open grassy clearing that is surrounded by a ring of palm trees. You can see a feeble lone tree in the center of the clearing and a cluster of boulders near the edge of the clearing. You can also see a mud pit near the boulders. Four paths from all directions intersect here.

* * *

>n
Volcano Slope
The slope of a towering active volcano in the middle of the island. The slope is covered with ash and underbrush. There is a small lava pit at the foot of the slope.

>unlock hidden door
What do you want to unlock the hidden door with?

* * *

>stone
You unlock the hidden door.

>n
The hidden door is closed.

>open door
You open the hidden door.

* * *

>n
dark tunnel
A dark tunnel dug under the slope of the volcano that looks to be man-made. The air is warm and the walls are lined with broken tunnel lights. Furthur down the tunnel, there are two large metal doors. One is to the north and one is to the east. There is an electronic keypad mounted on the wall between the two doors.

>n
The metal door is locked.

>e
The metal door is locked.

>x keypad
A small electric keypad located on the wall between the north and east lab doors. Located on the keypad are ten buttons: one for every number from 0-9.

>enter 133716 in the keypad
You can't use multiple objects with that verb.

>enter 13316 into the keypad
You can't use multiple objects with that verb.

>enter code into keypad
What in the world do i enter into the keypad?

>enter code into the keypad
What in the world do i enter into the keypad?

>put code in electronic keypad
What in the world do i enter into the keypad?

>enter code
(into the Electronic keypad)
What in the world do i enter into the keypad?

>enter the code
You can't see any such thing.

>enter code into the electronic keypad
What in the world do i enter into the keypad?

>s
Volcano Slope
The slope of a towering active volcano in the middle of the island. The slope is covered with ash and underbrush. There is a small lava pit at the foot of the slope.

>s
Clearing
A wide open grassy clearing that is surrounded by a ring of palm trees. You can see a feeble lone tree in the center of the clearing and a cluster of boulders near the edge of the clearing. You can also see a mud pit near the boulders. Four paths from all directions intersect here.

>take stone
You already have that.

>take rock
Taken.

* * *

>take line
Taken.

>combine stick and line
You can't use multiple objects with that verb.

>combine stick with line
You now have a tied stick.

* * *

>combine rock with handle
You now have a Stone axe.

>open door
It seems to be locked.

>cut planks
You chop and break the wooden planks. You can now open the door.

>open door
You open the wooden door.

* * *

>n
Old shack
A dark and musty shack. The walls are lined with shelves that hold misshapen skulls, flasks, and other unusual objects. How odd.

You can see a Scientist here.

>give scientist axe
The Scientist doesn't seem interested.

>give scientist fish
You can't see any such thing.

>give scientist fillet
The scientist hungrily snatches the fillet out of your hands.

>talk to scientist
Thank you so much, I was literally dying of starvation. Anyways, if you're trying to get off this island, there's a secret lab under the volcano to the north. Take these goggles to the lava tube on the east side of the island. With these special goggles, You should be able to find the passcode to the lab. Unfortunately, that's all I remember…Be careful.er慷獹

>s
Dirt path
An old dirt path lined with greenery. There is a hut to the north and a cave entrance to the west.

* * *

>x wall
The special goggles filter the markings on the wall, leaving only the faint scratches visible. You can clearly make out the number "133716" engraved in the wall. You pick up a leaf and scratch the number in with your fingernail. You put the leaf in your pocket.

>x paintings
Old cave paintings with the number "133716" etched in behind.

>i
You are carrying:
  a code
  a special goggles (being worn)
  a Stone axe
  a fishing rod
  a mysterious stone
  a rusty key

>x code
A leaf with the number "133716" scratched in.

>w
Volcano Slope
The slope of a towering active volcano in the middle of the island. The slope is covered with ash and underbrush. There is a small lava pit at the foot of the slope.

>n
dark tunnel
A dark tunnel dug under the slope of the volcano that looks to be man-made. The air is warm and the walls are lined with broken tunnel lights. Furthur down the tunnel, there are two large metal doors. One is to the north and one is to the east. There is an electronic keypad mounted on the wall between the two doors.

* * *

>n
The metal door is locked.

>enter code into keypad
You enter the number "133716" into the electronic keypad. You hear a small beeping sound coming from both the north and east metal doors.

* * *

>i
You are carrying:
  a code
  a special goggles (being worn)
  a Stone axe
  a fishing rod
  a mysterious stone
  a rusty key

>n
underground cove

>use keypad
You can't see any such thing.

>use electronic keypad
You can't see any such thing.

>s
dark tunnel
A dark tunnel dug under the slope of the volcano that looks to be man-made. The air is warm and the walls are lined with broken tunnel lights. Furthur down the tunnel, there are two large metal doors. One is to the north and one is to the east. There is an electronic keypad mounted on the wall between the two doors.

* * *

>undo
dark tunnel
[Previous turn undone.]

>undo
underground cove
[Previous turn undone.]

>undo
underground cove
[Previous turn undone.]

>und
That's not a verb I recognise.

>undo
underground cove
[Previous turn undone.]

>undo
dark tunnel
[Previous turn undone.]

>undo
"Undo" failed.  [Not all interpreters provide it.]

>x
What do you want to examine?

>n
You see nothing unexpected in that direction.

>s
Volcano Slope
The slope of a towering active volcano in the middle of the island. The slope is covered with ash and underbrush. There is a small lava pit at the foot of the slope.

>n
dark tunnel
A dark tunnel dug under the slope of the volcano that looks to be man-made. The air is warm and the walls are lined with broken tunnel lights. Furthur down the tunnel, there are two large metal doors. One is to the north and one is to the east. There is an electronic keypad mounted on the wall between the two doors.

>n
underground cove

>s
dark tunnel
A dark tunnel dug under the slope of the volcano that looks to be man-made. The air is warm and the walls are lined with broken tunnel lights. Furthur down the tunnel, there are two large metal doors. One is to the north and one is to the east. There is an electronic keypad mounted on the wall between the two doors.

* * *

>take key
Taken.

>x hole
Quarter-sized holes that are scattered all around the shore line.

>n
Clearing
A wide open grassy clearing that is surrounded by a ring of palm trees. You can see a feeble lone tree in the center of the clearing and a cluster of boulders near the edge of the clearing. You can also see a mud pit near the boulders. Four paths from all directions intersect here.

* * *

>e
Wetlands
A series of small ponds surrounded by tall grass and mangrove roots.

>w
Clearing
A wide open grassy clearing that is surrounded by a ring of palm trees. You can see a feeble lone tree in the center of the clearing and a cluster of boulders near the edge of the clearing. You can also see a mud pit near the boulders. Four paths from all directions intersect here.

* * *

>unlock gate
(with the rusty key)
You unlock the gate.

>x gate
A giant gate that covers the entire mouth of the cave entrance. It's probably here for a reason…entire

>open gate
You open the gate.

* * *

>n
The hidden door is locked.

>n
The hidden door is locked.

* * *

>unlock hidden door
What do you want to unlock the hidden door with?

>mysterious stone
You unlock the hidden door.

>n
The hidden door is closed.

* * *

>n
dark tunnel
A dark tunnel dug under the slope of the volcano that looks to be man-made. The air is warm and the walls are lined with broken tunnel lights.

>s
Volcano Slope
The slope of a towering active volcano in the middle of the island. The slope is covered with ash and underbrush. There is a small lava pit at the foot of the slope.

* * *

>take line
Taken.

* * *

>n
Clearing
A wide open grassy clearing that is surrounded by a ring of palm trees. You can see a feeble lone tree in the center of the clearing and a cluster of boulders near the edge of the clearing. You can also see a mud pit near the boulders. Four paths from all directions intersect here.

>s
Beach
A beautiful white sand beach that stretches around the entire island. Waves from the vast, sapphire ocean gently lap the shore. The sand here is littered with many crab holes. Palm trees line the dirt farther north up the beach.