You open your eyes. Your eyesight is blurry and it takes a while for you to realize that you are staring straight up at the cloudless blue sky. The faint squawk of birds slowly gets louder as you come back to your senses.  Still in a daze, you slowly sit up and look around. You find yourself sitting on the soft white sand of an empty beach. How in the world did you end up here? Your clothes is tattered and your entire body aches with pain. Carefully, you stand up and walk around, letting the warm sand slip through your bare toes. After examining your surroundings a bit more, you realize that you're on a small Island.

Jungle Terror
An Interactive Fiction by Braden Yoshinaga
Release 1 / Serial number 140227 / Inform 7 build 6G60 (I6/v6.32 lib 6/12N) SD

Beach
A beautiful white sand beach that stretches around the entire island. Waves from the vast, sapphire ocean gently lap the shore. The sand here is littered with many crab holes. Palm trees line the dirt farther north up the beach.

You can see a fishing line here.

I beg your pardon?

>n
Clearing
A wide open grassy clearing that is surrounded by a ring of palm trees. There is a lone tree in the center of the clearing and a cluster of boulders near the edge of the clearing. Four paths from all directions intersect here.

>x tree
A lonely tree that sits in the middle of the clearing. Its trunk is tall and feeble. Its leafless branches sadly slump towards the dirt.

High above you, way out of reach, you see skinny branches dangling from the weak trunk. Maybe you can somehow get one.

>shake tree
You grab hold of the feeble trunk and shake it violently. A skinny branch detaches iteself from the trunk and falls to the ground. You take a closer look at the branch and see that it is actually a strong, flexible stick.

* * *

>take stick
Taken.

>x branches
Skinny branches dangling from the weak trunk high above.

>shake tree
You grab hold of the feeble trunk and shake it violently. A skinny branch detaches iteself from the trunk and falls to the ground. You take a closer look at the branch and see that it is actually a strong, flexible stick.

* * *

>take stick
Taken.

>i
You are carrying:
  a flexible stick

* * *

>n
Clearing
A wide open grassy clearing that is surrounded by a ring of palm trees. There is a feeble lone tree in the center of the clearing and a cluster of boulders near the edge of the clearing. Four paths from all directions intersect here.

>boulders
That's not a verb I recognise.

>x boulders
A patch of large, black boulders. Most boulders are too large to move but there are other, smaller rocks scattered around.

You can see a sharp rock here.

* * *

>take sharp rock
Taken.

>x boulder
You can't see any such thing.

>x boulders
A patch of large, black boulders. Most boulders are too large to move but there are other, smaller rocks scattered around.

You can see a sharp rock here.

* * *

>n
Clearing
A wide open grassy clearing that is surrounded by a ring of palm trees. There is a feeble lone tree in the center of the clearing and a cluster of boulders near the edge of the clearing. Four paths from all directions intersect here.

>take sharp rock
hi

* * *

>n
Clearing
A wide open grassy clearing that is surrounded by a ring of palm trees. There is a feeble lone tree in the center of the clearing and a cluster of boulders near the edge of the clearing. Four paths from all directions intersect here.

>x boulder
A patch of large, black boulders. Most boulders are too large to move but there are other, smaller rocks scattered around.

You can see a sharp rock here.

>x boulder
A patch of large, black boulders. Most boulders are too large to move but there are other, smaller rocks scattered around.

* * *

>n
Clearing
A wide open grassy clearing that is surrounded by a ring of palm trees. There is a feeble lone tree in the center of the clearing and a cluster of boulders near the edge of the clearing. Four paths from all directions intersect here.

>take stick
You can't see any such thing.

>i
You are carrying:
  a flexible stick

* * *

>take stick
You can't see any such thing.

>x stick
You can't see any such thing.

>hit tree
You hit the feeble trunk of the tree. A skinny branch detaches itself from the trunk and falls to the ground. You take a closer look at the branch and see that it is actually a strong, flexible stick.

>x stick
A strong, skinny, flexible stick. This could be useful.

>take stick
Taken.

* * *

>take stick
You can't see any such thing.

>hit tree
You hit the feeble trunk of the tree. A skinny branch detaches itself from the trunk and falls to the ground. You take a closer look at the branch and see that it is actually a strong, flexible stick.

>hit stick
Violence isn't the answer to this one.

>take stick
Taken.

>hit tree
You hit the feeble trunk of the tree but nothing happens.

>x tree
A lonely tree that sits in the middle of the clearing. Its trunk is tall and feeble. Its leafless branches sadly slump towards the dirt.

>shake tree
You shake the feeble trunk but nothing happens.

* * *

>n
Clearing
A wide open grassy clearing that is surrounded by a ring of palm trees. There is a feeble lone tree in the center of the clearing and a cluster of boulders near the edge of the clearing. Four paths from all directions intersect here.

>x boulders
A patch of large, black boulders. Most boulders are too large to move but there are other, smaller rocks scattered around.

You can see a sharp rock here.

>x boulders
A patch of large, black boulders. Most boulders are too large to move but there are other, smaller rocks scattered around.

You can see a sharp rock here.

* * *

>take sharp rock
Taken.

>x boulders
A patch of large, black boulders. Most boulders are too large to move but there are other, smaller rocks scattered around.

>take rock
You already have that.

* * *

>x boulders
A patch of large, black boulders. Most boulders are too large to move but there are other, smaller rocks scattered around.

You can see a sharp rock here.

>s
Beach
A beautiful white sand beach that stretches around the entire island. Waves from the vast, sapphire ocean gently lap the shore. The sand here is littered with many crab holes. Palm trees line the dirt farther north up the beach.

You can see a fishing line here.

>n
Clearing
A wide open grassy clearing that is surrounded by a ring of palm trees. There is a feeble lone tree in the center of the clearing and a cluster of boulders near the edge of the clearing. Four paths from all directions intersect here.

>x boulders
A patch of large, black boulders. Most boulders are too large to move but there are other, smaller rocks scattered around.

* * *

>x boulders
sup

You can see a sharp rock here.

* * *

>n
Clearing
A wide open grassy clearing that is surrounded by a ring of palm trees. There is a feeble lone tree in the center of the clearing and a cluster of boulders near the edge of the clearing. Four paths from all directions intersect here.

>x tree
A lonely tree that sits in the middle of the clearing. Its trunk is tall and feeble. Its leafless branches sadly slump towards the dirt.

High above you, way out of reach, you see skinny branches dangling from the weak trunk. Maybe you can somehow get one.

>x branch
Skinny branches dangling from the weak trunk high above.

>x skinny branch
A skinny branch dangling from the weak trunk high above.

>x dangling branch
You can't see any such thing.

* * *

>x branch
Skinny branches dangling from the weak trunk high above.

>shake branch
You can't see any such thing.

>shake tree
You grab hold of the feeble trunk and shake it violently. A skinny branch detaches iteself from the trunk and falls to the ground. You take a closer look at the branch and see that it is actually a strong, flexible stick.

>x stick
A strong, skinny, flexible stick. This could be useful.

>take branch
You can't see any such thing.

* * *

>x branch
Skinny branches dangling from the weak trunk high above.

>shake tree
You grab hold of the feeble trunk and shake it violently. The skinny branch detaches iteself from the trunk and falls to the ground. You take a closer look at the branch and see that it is actually a strong, flexible stick.

>x stick
You see nothing special about the flexible stick.

>take stick
You pick up the flexible stick.

>i
You are carrying:
  a flexible stick

* * *

>x branch
Skinny branches dangling from the weak trunk high above.

>x branches
Skinny branches dangling from the weak trunk high above.

>take branches
That's hardly portable.

>shake tree
You grab hold of the feeble trunk and shake it violently. A skinny branch detaches iteself from the trunk and falls to the ground. You take a closer look at the branch and see that it is actually a strong, flexible stick.

>take stick
You pick up the flexible stick.

>x stick
A strong, skinny, flexible stick. This could be useful.

>x branch
Skinny branches dangling from the weak trunk high above.

>shake tree
You grab hold of the feeble trunk and shake it violently. A skinny branch detaches iteself from the trunk and falls to the ground. You take a closer look at the branch and see that it is actually a strong, flexible stick.

* * *

>x tree
A lonely tree that sits in the middle of the clearing. Its trunk is tall and feeble. Its leafless branches sadly slump towards the dirt.

High above you, way out of reach, you see skinny branches dangling from the weak trunk. Maybe you can somehow get one.

>x branches
Skinny branches dangling from the weak trunk high above.

>shake tree
You grab hold of the feeble trunk and shake it violently. The skinny branch detaches iteself from the trunk and falls to the ground. You take a closer look at the branch and see that it is actually a strong, flexible stick.

* * *

>x tree
A lonely tree that sits in the middle of the clearing. Its trunk is tall and feeble. Its leafless branches sadly slump towards the dirt.

High above you, way out of reach, you see skinny branches dangling from the weak trunk. Maybe you can somehow get one.

>x dangling branch
A skinny branch dangling from the weak trunk high above.

>x trunk
You can't see any such thing.

>shake tree
You grab hold of the feeble trunk and shake it violently. The skinny branch detaches iteself from the trunk and falls to the ground. You take a closer look at the branch and see that it is actually a strong, flexible stick.

>x branch
You can't see any such thing.

>x tree
A lonely tree that sits in the middle of the clearing. Its trunk is tall and feeble. Its leafless branches sadly slump towards the dirt.

High above you, way out of reach, you see a skinny branch dangling from the weak trunk. Maybe you can somehow get it.

>shake tree
You grab hold of the feeble trunk and shake it violently. The skinny branch detaches iteself from the trunk and falls to the ground. You take a closer look at the branch and see that it is actually a strong, flexible stick.

>take stick
You pick up the flexible stick.

>i
You are carrying nothing.

>i
You are carrying nothing.

>x stick
You see nothing special about the flexible stick.

>x flexible stick
You see nothing special about the flexible stick.

* * *

>x tree
A lonely tree that sits in the middle of the clearing. Its trunk is tall and feeble. Its leafless branches sadly slump towards the dirt.

High above you, way out of reach, you see skinny branches dangling from the weak trunk. Maybe you can somehow get one.

>take skinny branches
They're too far out of reach.

>hit tree
You hit the feeble trunk of the tree. A skinny branch detaches itself from the trunk and falls to the ground. You take a closer look at the branch and see that it is actually a strong, flexible stick.

>take branch
They're too far out of reach.

>take stick
Taken.

* * *

>i
You are carrying:
  a flexible stick

>x boulders
A patch of large, black boulders. Most boulders are too large to move but there are other, smaller rocks scattered around.

You can see a small, sharp rock here.

>take sharp rock
Taken.

>x boulders
A patch of large, black boulders. Most boulders are too large to move but there are other, smaller rocks scattered around.

You can see a small, sharp rock here.

>take rock
You already have that.

* * *

>x tree
A lonely tree that sits in the middle of the clearing. Its trunk is tall and feeble. Its leafless branches sadly slump towards the dirt.

High above you, way out of reach, you see skinny branches dangling from the weak trunk. Maybe you can somehow get one.

>hit tree
You hit the feeble trunk of the tree. A skinny branch detaches itself from the trunk and falls to the ground. You take a closer look at the branch and see that it is actually a strong, flexible stick.

>take flexible stick
Taken.

>hit tree
You hit the feeble trunk of the tree but nothing happens.

* * *

>shake tree
You shake the feeble trunk but nothing happens.

>i
You are carrying:
  a flexible stick