You open your eyes. Your eyesight is blurry and it takes a while for you to realize that you are staring straight up at the cloudless blue sky. The faint squawk of birds slowly gets louder as you come back to your senses.  Still in a daze, you slowly sit up and look around. You find yourself sitting on the soft white sand of an empty beach. How in the world did you end up here? Your clothes is tattered and your entire body aches with pain. Carefully, you stand up and walk around, letting the warm sand slip through your bare toes. After examining your surroundings a bit more, you realize that you're on a small Island.

Trouble in the Tropics
An Interactive Fiction by Braden Yoshinaga
Release 1 / Serial number 140310 / Inform 7 build 6G60 (I6/v6.32 lib 6/12N) SD

Beach
A beautiful white sand beach that stretches around the entire island. Waves from the vast, sapphire ocean gently lap the shore. The sand here is littered with many crab holes. Palm trees line the dirt farther north up the beach. The clearing is to the north.

You can see a thin line here.

>x thin line
A long, tough fishing line that washed up on the beach.

>take line
Taken.

>x me
Your clothes are tattered and your hair is a mess. Not a pretty sight.

>x beach
You can't see any such thing.

>x island
You're standing on it!

>xwaves
That's not a verb I recognise.

>x waves
Crystal clear sea water gently lapping the white sand.

>x ocean
A beautiful, sparkling, sapphire ocean that stretches to the horizon.

>x sand
Very fine white sand that is warm to the touch.

>take sand
Why are wasting your time trying to take sand? Besides, you have nothing to carry it in.

>n
Clearing
A wide open grassy clearing that is surrounded by a ring of palm trees. You can see a feeble lone tree in the center of the clearing and a cluster of boulders near the edge of the clearing. You can also see a mud pit near the boulders. Four paths from all directions intersect here. The volcano slope is to the north, the dirt path is to the west, the wetlands are to the east, and the beach is to the south.

>x palm trees
Tall, slender palms that line the edges of the clearing. Trees are missing where paths are formed.

>climb trees
I don't think much is to be achieved by that.

>x tree
A lonely tree that sits in the middle of the clearing. Its trunk is very tall and weak. The trunk looks as if it could collapse any moment. Its leafless branches sadly slump towards the dirt.

High above you, way out of reach, you see skinny branches dangling from the weak trunk. Maybe you can somehow get one.

>climb trees
I don't think much is to be achieved by that.

>climb tree
You hug the trunk and shimmy up the tree. When you reach the top, you hear the sound of cracking wood below. You scream in terror as the feeble trunk collapses and you fall to the ground.

    *** You fell to your death ***

Would you like to RESTART, RESTORE a saved game, QUIT or UNDO the last command?

>undo
Clearing
[Previous turn undone.]

>eat tree
(first taking the lone tree)
That's hardly portable.

>x boulders
A patch of large, black boulders. Most boulders are too large to move but there are other, smaller rocks scattered around.

You can see a sharp rock here.

>take rock
Taken.

>x rock
A rock with one sharp, serrated side that resembles a blade edge.

>cut tree
Cutting that up would achieve little.

>l
Clearing
A wide open grassy clearing that is surrounded by a ring of palm trees. You can see a feeble lone tree in the center of the clearing and a cluster of boulders near the edge of the clearing. You can also see a mud pit near the boulders. Four paths from all directions intersect here. The volcano slope is to the north, the dirt path is to the west, the wetlands are to the east, and the beach is to the south.

>x mud pit
A small pit filled with warm, thick mud.

You can see a worm on the surface of the mud.

>take mud
That's hardly portable.

>take worm
Taken.

>dig
That's not a verb I recognise.

>eat worm
You're not that messed up are you? Try putting the worm to better use.

>e
Wetlands
A series of small ponds surrounded by tall grass and mangrove plants. The lava tube is to the north and the clearing is to the west.

>x pond
A small pond that is connected to a river flowing from the north, and the ocean to the south. This pond is home to many fish.

>x ponds
A small pond that is connected to a river flowing from the north, and the ocean to the south. This pond is home to many fish.

>x grass
Tall grass and reeds that come up to your waist.

>take grass
That's hardly portable.

>x mangrove
Mangrove plants that are elevated above the ground on their tall roots.

>climb mangrove
I don't think much is to be achieved by that.

>n
Lava Tube
An old lava tube that is now empty. There are strange markings engraved into the shiny black rock walls.

>x markings
Cave paintings and hieroglyphs that look to have been engraved into the rock wall long ago. There are also some faint scratches that look out of place.

>x scratches
You can't see any such thing.

>x faint scratches
You can't see any such thing.

>s
Wetlands
A series of small ponds surrounded by tall grass and mangrove plants. The lava tube is to the north and the clearing is to the west.

>e
You can't go that way.

>w
Clearing
A wide open grassy clearing that is surrounded by a ring of palm trees. You can see a feeble lone tree in the center of the clearing and a cluster of boulders near the edge of the clearing. You can also see a mud pit near the boulders. Four paths from all directions intersect here. The volcano slope is to the north, the dirt path is to the west, the wetlands are to the east, and the beach is to the south.

>n
Volcano Slope
The slope of a towering active volcano in the middle of the island. The slope is covered with ash and underbrush. There is a small lava pit at the foot of the slope. The lava tube is to the east and the clearing is to the south.

>x ash
Fine ash particles that blanket the slope.

>take ash
You don't need that!

>x underbrush
Volcanic ferns and skinny trees that are rooted on the slope of the volcano. You notice a door built into the side of the volcano behind one of the ferns.

>open door
It seems to be locked.

>n
The hidden door is locked.

>l
Volcano Slope
The slope of a towering active volcano in the middle of the island. The slope is covered with ash and underbrush. There is a small lava pit at the foot of the slope. The lava tube is to the east and the clearing is to the south.

>x lava pit
A pit filled with molten hot lava. The heat emitted from the pit feels like the heat of a stove.

>x slope
You can't see any such thing.

>s
Clearing
A wide open grassy clearing that is surrounded by a ring of palm trees. You can see a feeble lone tree in the center of the clearing and a cluster of boulders near the edge of the clearing. You can also see a mud pit near the boulders. Four paths from all directions intersect here. The volcano slope is to the north, the dirt path is to the west, the wetlands are to the east, and the beach is to the south.

>w
Dirt Path
An old dirt path lined with greenery. There is a hut to the north and a gate to the west.

You can see a wooden handle here.

>take wooden handle
Taken.

>combine handle with stick
You can't see any such thing.

>i
You are carrying:
  a wooden handle
  a worm
  a sharp rock
  a thin line

>combine handle with worm
You can't combine the wooden handle and the worm into anything useful.

>eat worm
You're not that messed up are you? Try putting the worm to better use.

>combine wooden handle with rock
You shove the sharp rock into the wooden handle. You have created a stone axe.

>l
Dirt Path
An old dirt path lined with greenery. There is a hut to the north and a gate to the west.

>x greenery
Various bushes and trees that line the dirt path.

>w
The gate at the cave entrance is locked.

>unlock gate
What do you want to unlock the Gate with?

>me
(first taking yourself)
You are always self-possessed.

>e
Clearing
A wide open grassy clearing that is surrounded by a ring of palm trees. You can see a feeble lone tree in the center of the clearing and a cluster of boulders near the edge of the clearing. You can also see a mud pit near the boulders. Four paths from all directions intersect here. The volcano slope is to the north, the dirt path is to the west, the wetlands are to the east, and the beach is to the south.

>n
Volcano Slope
The slope of a towering active volcano in the middle of the island. The slope is covered with ash and underbrush. There is a small lava pit at the foot of the slope. The lava tube is to the east and the clearing is to the south.

>w
You can't go that way.

>s
Clearing
A wide open grassy clearing that is surrounded by a ring of palm trees. You can see a feeble lone tree in the center of the clearing and a cluster of boulders near the edge of the clearing. You can also see a mud pit near the boulders. Four paths from all directions intersect here. The volcano slope is to the north, the dirt path is to the west, the wetlands are to the east, and the beach is to the south.

>w
Dirt Path
An old dirt path lined with greenery. There is a hut to the north and a gate to the west.

>x hut
A round and old wooden shack with a pointed straw roof. The walls of the shack are lined with giant scratches that look like claw marks.

>n
The wooden door to the shack won't budge. It is locked with wooden planks that are nailed to the front of the door. Maybe you could somehow break them.

>break door with axe
You chop and break the wooden planks. You can now open the door.

>n
The door is closed.

>open door
You open the Wooden Door.

>n
Old Shack
A dark and musty shack. The walls are lined with shelves that hold misshapen skulls, flasks, and other unusual objects. How odd. The dirt path is to the south.

You can see a Scientist here.

>attack scientist
The last thing you would want to do when you're stranded on an island is to attack a potential ally.

>talk to scientist
Food…please…

>x skulls
Unusual skulls that don't resemble the skull of anything you are familiar with.

>take skull
That's hardly portable.

>x flask
Various types of flasks that you recognize from chemistry class.

>take flask
That's hardly portable.

>x other unusual objects
Unusual science objects.

>take
(the Scientist)
Let's not kidnap a scientist.

>x me
Your clothes are tattered and your hair is a mess. Not a pretty sight.

>s
Dirt Path
An old dirt path lined with greenery. There is a hut to the north and a gate to the west.

>e
Clearing
A wide open grassy clearing that is surrounded by a ring of palm trees. You can see a feeble lone tree in the center of the clearing and a cluster of boulders near the edge of the clearing. You can also see a mud pit near the boulders. Four paths from all directions intersect here. The volcano slope is to the north, the dirt path is to the west, the wetlands are to the east, and the beach is to the south.

>cut branch with axe
They're too far out of reach.

>cut tree
Cutting that up would achieve little.

>cut tree with axe
Don't be a tree killer! Why not just give the tree a little shake?

>shake tree
You grab hold of the feeble trunk and shake it violently. A skinny branch detaches iteself from the trunk and falls to the ground. You take a closer look at the branch and see that it is actually a strong, flexible stick.

>combine stick with line
(first taking the flexible stick)
You tie the fishing line into a notch at the end of the stick. You have created an unfinished rod.

>combine rod with worm
You tie the worm to the end of the fishing line on the unfinished rod. You have created a fishing rod.

>x rod
A makeshift and fully-functional fishing rod.

>s
Beach
A beautiful white sand beach that stretches around the entire island. Waves from the vast, sapphire ocean gently lap the shore. The sand here is littered with many crab holes. Palm trees line the dirt farther north up the beach. The clearing is to the north.

>x crab holes
Quarter-sized holes that are scattered all around the shore line.

Something shiny catches your eye in one of the holes near your feet. You take a closer look and see that it's a rusty key.

>take key
Taken.

>n
Clearing
A wide open grassy clearing that is surrounded by a ring of palm trees. You can see a feeble lone tree in the center of the clearing and a cluster of boulders near the edge of the clearing. You can also see a mud pit near the boulders. Four paths from all directions intersect here. The volcano slope is to the north, the dirt path is to the west, the wetlands are to the east, and the beach is to the south.

>n
Volcano Slope
The slope of a towering active volcano in the middle of the island. The slope is covered with ash and underbrush. There is a small lava pit at the foot of the slope. The lava tube is to the east and the clearing is to the south.

* * *

>s
Clearing
A wide open grassy clearing that is surrounded by a ring of palm trees. You can see a feeble lone tree in the center of the clearing and a cluster of boulders near the edge of the clearing. You can also see a mud pit near the boulders. Four paths from all directions intersect here. The volcano slope is to the north, the dirt path is to the west, the wetlands are to the east, and the beach is to the south.

>e
Wetlands
A series of small ponds surrounded by tall grass and mangrove plants. The lava tube is to the north and the clearing is to the west.

>fish
(in the small ponds)
You throw your line in the pond and wait for a bite. It's not long until you feel something tugging on your line. You pull in your line and see a raw mullet on the end.

>e
You can't go that way.

* * *

>n
Volcano Slope
The slope of a towering active volcano in the middle of the island. The slope is covered with ash and underbrush. There is a small lava pit at the foot of the slope. The lava tube is to the east and the clearing is to the south.

>cook fish
(in the small lava pit)

>put fish over lava
You can't see any such thing.

>cook mullet
(in the small lava pit)

>i
You are carrying:
  a rusty key
  a fishing rod
  a Stone axe

>takemullet
That's not a verb I recognise.

>take mullet
You can't see any such thing.

>s
Clearing
A wide open grassy clearing that is surrounded by a ring of palm trees. You can see a feeble lone tree in the center of the clearing and a cluster of boulders near the edge of the clearing. You can also see a mud pit near the boulders. Four paths from all directions intersect here. The volcano slope is to the north, the dirt path is to the west, the wetlands are to the east, and the beach is to the south.

>e
Wetlands
A series of small ponds surrounded by tall grass and mangrove plants. The lava tube is to the north and the clearing is to the west.

You can see a raw mullet here.

>take mullet
Taken.

>w
Clearing
A wide open grassy clearing that is surrounded by a ring of palm trees. You can see a feeble lone tree in the center of the clearing and a cluster of boulders near the edge of the clearing. You can also see a mud pit near the boulders. Four paths from all directions intersect here. The volcano slope is to the north, the dirt path is to the west, the wetlands are to the east, and the beach is to the south.

* * *

>n
Volcano Slope
The slope of a towering active volcano in the middle of the island. The slope is covered with ash and underbrush. There is a small lava pit at the foot of the slope. The lava tube is to the east and the clearing is to the south.

>cook fish
(in the small lava pit)
You carefully hold the raw mullet over the fire pit. After a while, the mullet cooks and becomes brown and crispy. You now have a cooked mullet.

>i
You are carrying:
  a cooked mullet
  a rusty key
  a fishing rod
  a Stone axe

>s
Clearing
A wide open grassy clearing that is surrounded by a ring of palm trees. You can see a feeble lone tree in the center of the clearing and a cluster of boulders near the edge of the clearing. You can also see a mud pit near the boulders. Four paths from all directions intersect here. The volcano slope is to the north, the dirt path is to the west, the wetlands are to the east, and the beach is to the south.

* * *

>w
Dirt Path
An old dirt path lined with greenery. There is a hut to the north and a gate to the west.

>n
Old Shack
A dark and musty shack. The walls are lined with shelves that hold misshapen skulls, flasks, and other unusual objects. How odd. The dirt path is to the south.

You can see a Scientist here.

>give fish to scientist
You can't see any such thing.

>give cooked fish to scientist
The scientist hungrily snatches the cooked mullet out of your hands.

>talk to scientist
Thank you so much, I was literally dying of starvation. Anyways, if you're trying to get off this island, there's a secret lab under the volcano to the north. Take these goggles to the lava tube on the east side of the island. With these special goggles, You should be able to find the passcode to the lab. Unfortunately, that's all I remember…Be careful.

>i
You are carrying:
  a special goggles
  a rusty key
  a fishing rod
  a Stone axe

>wear goggles
You put on the special goggles.

>s
Dirt Path
An old dirt path lined with greenery. There is a hut to the north and a gate to the west.

* * *

>e
Clearing
A wide open grassy clearing that is surrounded by a ring of palm trees. You can see a feeble lone tree in the center of the clearing and a cluster of boulders near the edge of the clearing. You can also see a mud pit near the boulders. Four paths from all directions intersect here. The volcano slope is to the north, the dirt path is to the west, the wetlands are to the east, and the beach is to the south.

>e
Wetlands
A series of small ponds surrounded by tall grass and mangrove plants. The lava tube is to the north and the clearing is to the west.

>n
Lava Tube
An old lava tube that is now empty. There are strange markings engraved into the shiny black rock walls.

>x markings
The special goggles filter the markings on the wall, leaving only the faint scratches visible. You can clearly make out the number "133716" engraved in the wall. You pick up a leaf and scratch the number in with your fingernail. You put the leaf in your pocket.

>s
Wetlands
A series of small ponds surrounded by tall grass and mangrove plants. The lava tube is to the north and the clearing is to the west.

>w
Clearing
A wide open grassy clearing that is surrounded by a ring of palm trees. You can see a feeble lone tree in the center of the clearing and a cluster of boulders near the edge of the clearing. You can also see a mud pit near the boulders. Four paths from all directions intersect here. The volcano slope is to the north, the dirt path is to the west, the wetlands are to the east, and the beach is to the south.

>e
Wetlands
A series of small ponds surrounded by tall grass and mangrove plants. The lava tube is to the north and the clearing is to the west.

>w
Clearing
A wide open grassy clearing that is surrounded by a ring of palm trees. You can see a feeble lone tree in the center of the clearing and a cluster of boulders near the edge of the clearing. You can also see a mud pit near the boulders. Four paths from all directions intersect here. The volcano slope is to the north, the dirt path is to the west, the wetlands are to the east, and the beach is to the south.

* * *

>n
Volcano Slope
The slope of a towering active volcano in the middle of the island. The slope is covered with ash and underbrush. There is a small lava pit at the foot of the slope. The lava tube is to the east and the clearing is to the south.

>unlock door with key
That doesn't seem to fit the lock.

>s
Clearing
A wide open grassy clearing that is surrounded by a ring of palm trees. You can see a feeble lone tree in the center of the clearing and a cluster of boulders near the edge of the clearing. You can also see a mud pit near the boulders. Four paths from all directions intersect here. The volcano slope is to the north, the dirt path is to the west, the wetlands are to the east, and the beach is to the south.

* * *

>w
Dirt Path
An old dirt path lined with greenery. There is a hut to the north and a gate to the west.

>w
The gate at the cave entrance is locked.

>unlock with key
You can't see any such thing.

>unlock door with key
That's unlocked at the moment.

>n
Old Shack
A dark and musty shack. The walls are lined with shelves that hold misshapen skulls, flasks, and other unusual objects. How odd. The dirt path is to the south.

You can see a Scientist here.

>s
Dirt Path
An old dirt path lined with greenery. There is a hut to the north and a gate to the west.

>w
The gate at the cave entrance is locked.

* * *

>unlock with key
You can't see any such thing.

>i
You are carrying:
  a code
  a special goggles (being worn)
  a rusty key
  a fishing rod
  a Stone axe

>unlock gate with key
You unlock the Gate.

>w
The gate at the cave entrance closed.

>open gate
You open the Gate.

>w
Cave
A dark and spacious cave that seems to extend much farther undergound. The only sound that can be heard here is the water droplets falling from the ceiling. The dirt path is to the east.

You can see a mysterious stone here.

>take stone
(the mysterious stone)
Taken.

>save
Please supply a filename for save
Ok.

* * *

>x shore
The area where the sparkling ocean meets the white sand on the beach.

>x holes
Quarter-sized holes that are scattered all around the shore line.

Something shiny catches your eye in one of the holes near your feet. You take a closer look and see that it's a rusty key.

>x trees
Tall, slender palms that lazily sway in the breeze.

>x dirt
Dirty dirt.

>n
Clearing
A wide open grassy clearing that is surrounded by a ring of palm trees. You can see a feeble lone tree in the center of the clearing and a cluster of boulders near the edge of the clearing. You can also see a mud pit near the boulders. Four paths from all directions intersect here. The volcano slope is to the north, the dirt path is to the west, the wetlands are to the east, and the beach is to the south.

>x grass
A thin layer of light green grass.

>x ring
Tall, slender palms that line the edges of the clearing. Trees are missing where paths are formed.

>x palms
Tall, slender palms that line the edges of the clearing. Trees are missing where paths are formed.

>x tree
A lonely tree that sits in the middle of the clearing. Its trunk is very tall and weak. The trunk looks as if it could collapse any moment. Its leafless branches sadly slump towards the dirt.

High above you, way out of reach, you see skinny branches dangling from the weak trunk. Maybe you can somehow get one.

>x branches
Skinny branches dangling from the weak trunk high above.

>x boulders
A patch of large, black boulders. Most boulders are too large to move but there are other, smaller rocks scattered around.

You can see a sharp rock here.

>x small rocks
You can't see any such thing.

* * *

>take thin line
Taken.

>n
Clearing
A wide open grassy clearing that is surrounded by a ring of palm trees. You can see a feeble lone tree in the center of the clearing and a cluster of boulders near the edge of the clearing. You can also see a mud pit near the boulders. Four paths from all directions intersect here. The volcano slope is to the north, the dirt path is to the west, the wetlands are to the east, and the beach is to the south.

>take worm
Taken.

>take rock
Taken.

>shake tree
You grab hold of the feeble trunk and shake it violently. A skinny branch detaches iteself from the trunk and falls to the ground. You take a closer look at the branch and see that it is actually a strong, flexible stick.

>take stick
Taken.

>combin stick and line
That's not a verb I recognise.

>combine stick with line
You tie the fishing line into a notch at the end of the stick. You have created an unfinished rod.

>combine rod with worm
You tie the worm to the end of the fishing line on the unfinished rod. You have created a fishing rod.

>e
Wetlands
A series of small ponds surrounded by tall grass and mangrove roots. The lava tube is to the north and the clearing is to the west.

>fish
(in the small ponds)
You throw your line in the pond and wait for a bite. It's not long until you feel something tugging on your line. You pull in your line and see a raw mullet on the end.

>take mullet
Taken.

* * *

>cook fish
(in the small lava pit)
You carefully hold the raw mullet over the fire pit. After a while, the mullet cooks and becomes brown and crispy. You now have a cooked mullet.

>s
Clearing
A wide open grassy clearing that is surrounded by a ring of palm trees. You can see a feeble lone tree in the center of the clearing and a cluster of boulders near the edge of the clearing. You can also see a mud pit near the boulders. Four paths from all directions intersect here. The volcano slope is to the north, the dirt path is to the west, the wetlands are to the east, and the beach is to the south.

* * *

>w
Dirt Path
An old dirt path lined with greenery. There is a hut to the north and a gate to the west.

You can see a wooden handle here.

>take handle
Taken.

>combine handle with rock
You shove the sharp rock into the wooden handle. You have created a stone axe.

>cut planks
You must supply a second noun.

>open door
It seems to be locked.

>n
The wooden door to the shack won't budge. It is locked with wooden planks that are nailed to the front of the door. Maybe you could somehow break them.

>cut planks with axe
You chop and break the wooden planks. You can now open the door.

>open door
You open the Wooden Door.

* * *

>n
Old Shack
A dark and musty shack. The walls are lined with shelves that hold misshapen skulls, flasks, and other unusual objects. How odd. The dirt path is to the south.

You can see a Scientist here.

>give scientist fish
You can't see any such thing.

>give scientist mullet
The scientist hungrily snatches the cooked mullet out of your hands.

>talk to scientist
Thank you so much, I was literally dying of starvation. Anyways, if you're trying to get off this island, there's a secret lab under the volcano to the north. Take these goggles to the lava tube on the east side of the island. With these special goggles, You should be able to find the passcode to the lab. Unfortunately, that's all I remember…Be careful.

>s
Dirt Path
An old dirt path lined with greenery. There is a hut to the north and a gate to the west.

* * *

>e
Clearing
A wide open grassy clearing that is surrounded by a ring of palm trees. You can see a feeble lone tree in the center of the clearing and a cluster of boulders near the edge of the clearing. You can also see a mud pit near the boulders. Four paths from all directions intersect here. The volcano slope is to the north, the dirt path is to the west, the wetlands are to the east, and the beach is to the south.

>s
Beach
A beautiful white sand beach that stretches around the entire island. Waves from the vast, sapphire ocean gently lap the shore. The sand here is littered with many crab holes. Palm trees line the dirt farther north up the beach. The clearing is to the north.

>x hole
Quarter-sized holes that are scattered all around the shore line.

Something shiny catches your eye in one of the holes near your feet. You take a closer look and see that it's a rusty key.

>take key
Taken.

* * *

>n
Clearing
A wide open grassy clearing that is surrounded by a ring of palm trees. You can see a feeble lone tree in the center of the clearing and a cluster of boulders near the edge of the clearing. You can also see a mud pit near the boulders. Four paths from all directions intersect here. The volcano slope is to the north, the dirt path is to the west, the wetlands are to the east, and the beach is to the south.

>w
Dirt Path
An old dirt path lined with greenery. There is a hut to the north and a gate to the west.

* * *

>unlock gate
What do you want to unlock the Gate with?

>key
You unlock the Gate.

>open gate
You open the Gate.

* * *

>take stone
(the mysterious stone)
Taken.

>w
You can't go that way.

>e
Dirt Path
An old dirt path lined with greenery. There is a hut to the north and a gate to the west.

>e
Clearing
A wide open grassy clearing that is surrounded by a ring of palm trees. You can see a feeble lone tree in the center of the clearing and a cluster of boulders near the edge of the clearing. You can also see a mud pit near the boulders. Four paths from all directions intersect here. The volcano slope is to the north, the dirt path is to the west, the wetlands are to the east, and the beach is to the south.

>e
Wetlands
A series of small ponds surrounded by tall grass and mangrove roots. The lava tube is to the north and the clearing is to the west.

>n
Lava Tube
An old lava tube that is now empty. There are strange markings engraved into the shiny black rock walls.

>wear goggles
You put on the special goggles.

>x wall
The special goggles filter the markings on the wall, leaving only the faint scratches visible. You can clearly make out the number "133716" engraved in the wall. You pick up a leaf and scratch the number in with your fingernail. You put the leaf in your pocket.

>e
You can't go that way.

>w
Volcano Slope
The slope of a towering active volcano in the middle of the island. The slope is covered with ash and underbrush. There is a small lava pit at the foot of the slope. The lava tube is to the east and the clearing is to the south.

>unlock hidden door with stone
Which do you mean, the mysterious stone or the Stone axe?

>mysterious stone
You unlock the Hidden Door.

>open door
You open the Hidden Door.

>n
Dark Tunnel
A dark tunnel dug under the slope of the volcano that looks to be man-made. The air is warm and the walls are lined with broken tunnel lights. Further down the tunnel, there are two large metal doors. One is to the north and one is to the east. There is an electronic keypad mounted on the wall between the two doors.

>enter code
You enter the number "133716" into the electronic keypad. After a while, you hear a small beeping sound coming from both the north and east metal doors. As soon as the beeping stops, both doors slide open with a puff of white mist.

>e
Secret Lab
A secret lab built under a volcano? Sounds like something straight out of a sci-fi movie! Flasks and beakers of different shapes and sizes line the shelves and tabletops. Rows of beeping machines are located in the far corner of the lab. The dark tunnel is to the east and the experiment room is to the north.

You can see an uncharged battery and a key card here.

>take card
Taken.

>take battery
Taken.

>n
Experiment Room
A dark room packed with empty animal pens and cages. Giant claw marks stretch across the blood-stained walls. There are three large cryo tubes sitting in the middle of the room. Next to one of the cryo tubes is a small sample safe. The underground cove is to the west and the secret lab is to the south.

You can see a sample safe (closed) here.

>unlock sample safe with card
You unlock the sample safe.

>open sample safe
You open the sample safe, revealing Vial x, Vial y and Vial z.

>take x
Taken.

>take y
Taken.

>mix x and y
You can't use multiple objects with that verb.

>mix x with y
You now have battery fluid.

>put battery fluid in battery
Which do you mean, battery fluid or the uncharged battery?

>uncharged battery
You now have a charged battery.

>w
Underground Cove
A hidden cove where the ocean flows underneath the volcano. This cove serves as a secret lab entrance for boats and other ocean vehicles. There is a small submarine floating in the water near some tall rocks. The dark tunnel is to the south and the experiment room is to the east.

You can see a Broken submarine (empty) here.

>fix sub
You plug the charged battery into the empty space next to the engine. You climb into the submarine and start the engine. The propeller successfuly starts and you begin your descent away from the island.

    *** You have won ***

Would you like to RESTART, RESTORE a saved game, QUIT or UNDO the last command?

>undo
Underground Cove
[Previous turn undone.]

>put battery in sub
You plug the charged battery into the empty space next to the engine. You climb into the submarine and start the engine. The propeller successfuly starts and you begin your descent away from the island.

    *** You have won ***

Would you like to RESTART, RESTORE a saved game, QUIT or UNDO the last command?

>undo
Underground Cove
[Previous turn undone.]

>place battery in sub
You plug the charged battery into the empty space next to the engine. You climb into the submarine and start the engine. The propeller successfuly starts and you begin your descent away from the island.

    *** You have won ***

Would you like to RESTART, RESTORE a saved game, QUIT or UNDO the last command?

* * *

>take line
Taken.

>n
Clearing
A wide open grassy clearing that is surrounded by a ring of palm trees. You can see a feeble lone tree in the center of the clearing and a cluster of boulders near the edge of the clearing. You can also see a mud pit near the boulders. Four paths from all directions intersect here. The volcano slope is to the north, the dirt path is to the west, the wetlands are to the east, and the beach is to the south.

>s
Beach
A beautiful white sand beach that stretches around the entire island. Waves from the vast, sapphire ocean gently lap the shore. The sand here is littered with many crab holes. Palm trees line the dirt farther north up the beach.

>x hole
Quarter-sized holes that are scattered all around the shore line.

Something shiny catches your eye in one of the holes near your feet. You take a closer look and see that it's a rusty key.

* * *

>take key
Taken.

>n
Clearing
A wide open grassy clearing that is surrounded by a ring of palm trees. You can see a feeble lone tree in the center of the clearing and a cluster of boulders near the edge of the clearing. You can also see a mud pit near the boulders. Four paths from all directions intersect here.

>shake tree
You grab hold of the feeble trunk and shake it violently. A skinny branch detaches iteself from the trunk and falls to the ground. You take a closer look at the branch and see that it is actually a strong, flexible stick.

* * *

>take stick
Taken.

>take rock
Taken.

>take worm
Taken.

>combine stick with line
You now have a tied stick.

>combine stick with worm
You now have a fishing rod.

>e
Wetlands
A series of small ponds surrounded by tall grass and mangrove roots. A lava tube is to the north.

>fish in pond
You throw your line in the pond and wait for a bite. It's not long until you feel something tugging on your line. You pull in your line and see a baby mullet on the end.

>w
Clearing
A wide open grassy clearing that is surrounded by a ring of palm trees. You can see a feeble lone tree in the center of the clearing and a cluster of boulders near the edge of the clearing. You can also see a mud pit near the boulders. Four paths from all directions intersect here.

>e
Wetlands
A series of small ponds surrounded by tall grass and mangrove roots. A lava tube is to the north.

You can see a raw mullet here.

>take mullet
Taken.

>e
You can't go that way.

>w
Clearing
A wide open grassy clearing that is surrounded by a ring of palm trees. You can see a feeble lone tree in the center of the clearing and a cluster of boulders near the edge of the clearing. You can also see a mud pit near the boulders. Four paths from all directions intersect here.

>n
Volcano Slope
The slope of a towering active volcano in the middle of the island. The slope is covered with ash and underbrush. There is a small lava pit at the foot of the slope.

>cook mullet in lava pit
You carefully hold the raw mullet over the fire pit. After a while, the mullet cooks and becomes brown and crispy.

>s
Clearing
A wide open grassy clearing that is surrounded by a ring of palm trees. You can see a feeble lone tree in the center of the clearing and a cluster of boulders near the edge of the clearing. You can also see a mud pit near the boulders. Four paths from all directions intersect here.

>w
Dirt path
An old dirt path lined with greenery. There is a hut to the north and a cave entrance to the west.

You can see a wooden handle here.

>take handle
Taken.

>combine handle with rock
You now have a Stone axe.

>break planks
You chop and break the wooden planks. You can now open the door.

>open door
You open the wooden door.

>n
Old shack
A dark and musty shack. The walls are lined with shelves that hold misshapen skulls, flasks, and other unusual objects. How odd.

You can see a Scientist here.

>give scientist fillet
The scientist hungrily snatches the fillet out of your hands.

>talk to scientist
Thank you so much, I was literally dying of starvation. Anyways, if you're trying to get off this island, there's a secret lab under the volcano to the north. Take these goggles to the lava tube on the east side of the island. With these special goggles, You should be able to find the passcode to the lab. Unfortunately, that's all I remember…Be careful.er慷獹‬晩礠畯'

>s
Dirt path
An old dirt path lined with greenery. There is a hut to the north and a cave entrance to the west.

>w
The gate is locked.

>unlock gate
What do you want to unlock the gate with?

>key
You unlock the gate.

>open gate
You open the gate.

>w
cave entrance
A dark and gaping cave entrance. The entire mouth of the cave has been blocked by a locked gate. The gate is littered with warning and danger signs. How eerie…

You can see a mysterious stone here.

>take stone
(the mysterious stone)
Taken.

>e
Dirt path
An old dirt path lined with greenery. There is a hut to the north and a cave entrance to the west.

>ee
That's not a verb I recognise.

>e
Clearing
A wide open grassy clearing that is surrounded by a ring of palm trees. You can see a feeble lone tree in the center of the clearing and a cluster of boulders near the edge of the clearing. You can also see a mud pit near the boulders. Four paths from all directions intersect here.

>e
Wetlands
A series of small ponds surrounded by tall grass and mangrove roots. A lava tube is to the north.

>n
Lava tube
An old lava tube that is now empty. There are strange markings engraved into the shiny black rock walls.

>wear goggles
You put on the special goggles.

* * *

>x wall
The special goggles filter the markings on the wall, leaving only the faint scratches visible. You can clearly make out the number "133716" engraved in the wall. You pick up a leaf and scratch the number in with your fingernail. You put the leaf in your pocket.

>w
Volcano Slope
The slope of a towering active volcano in the middle of the island. The slope is covered with ash and underbrush. There is a small lava pit at the foot of the slope.

>open hidden door
It seems to be locked.

>unlock hidden door
What do you want to unlock the hidden door with?

>stone
Which do you mean, the mysterious stone or the Stone axe?

>mysterious stone
You unlock the hidden door.

>open door
You open the hidden door.

>n
dark tunnel
A dark tunnel dug under the slope of the volcano that looks to be man-made. The air is warm and the walls are lined with broken tunnel lights. Furthur down the tunnel, there are two large metal doors. One is to the north and one is to the east. There is an electronic keypad mounted on the wall between the two doors.

>enter code
That's not something you can enter.

>enter code into keypad
You enter the number "133716" into the electronic keypad. After a while, you hear a small beeping sound coming from both the north and east metal doors. As soon as the beeping stops, both doors slide open with a puff of white mist.

>e
Secret lab
A secret lab built under a volcano? Sounds like something straight out of a sci-fi movie! Flasks and beakers of different shapes and sizes line the shelves and tabletops. Rows of beeping machines are located in the far corner of the lab.

You can see an uncharged battery and a key card here.

>take battery
Taken.

>take card
Taken.

>n
experiment room
A dark room packed with empty animal pens and cages. Giant claw marks stretch across the blood-stained walls. There are three large liquid-filled body capsules sit in the middle of the room. Next to one of the capsules is a small sample safe.

You can see a sample safe (closed) here.

>open safe
It seems to be locked.

>unlock safe
What do you want to unlock the sample safe with?

>card
You unlock the sample safe.

>open safe
You open the sample safe, revealing Vial x, Vial y and Vial z.

>take x
Taken.

* * *

>take y
Taken.

>combine x with y
You now have battery fluid.

>undo
experiment room
[Previous turn undone.]

>i
You are carrying:
  Vial y
  Vial x
  a key card
  an uncharged battery
  a code
  a mysterious stone
  a special goggles (being worn)
  a Stone axe
  a fishing rod
  a rusty key

>x safe
A small glass sample safe that contains three liquid-filled vials labeled x, y, and z. There is a card slot on the safe door.

In the sample safe is Vial z.

>take z
Taken.

>combine z with y
You now have volatile substance.

    *** You created a volatile substance and died of an explosion ***

Would you like to RESTART, RESTORE a saved game, QUIT or UNDO the last command?

>undo
experiment room
[Previous turn undone.]

>combine y with x
You now have battery fluid.

>combine fluid with battery
Which do you mean, battery fluid or the uncharged battery?

>uncharged battery
You now have a charged battery.

>i
You are carrying:
  a charged battery
  Vial z
  a key card
  a code
  a mysterious stone
  a special goggles (being worn)
  a Stone axe
  a fishing rod
  a rusty key

>e
You can't go that way.

>w
underground cove
A hidden cove where the ocean flows underneath the volcano. This cove serves as a secret lab entrance for boats and other ocean vehicles. There is a small submarine floating in the water near some tall rocks.

You can see a Broken submarine (empty) here.

>put charged battery in sub
You put the charged battery into the Broken submarine.

>i
You are carrying:
  Vial z
  a key card
  a code
  a mysterious stone
  a special goggles (being worn)
  a Stone axe
  a fishing rod
  a rusty key

>take charged battery
Taken.

>place charged battery in sub
You can't see any such thing.

>place charged battery in submarine
You can't see any such thing.

>x sub
A broken one-passenger submarine bobbing in the water. There is an empty slot near the engine. Maybe the submarine can be fixed…

>i
You are carrying:
  a charged battery
  Vial z
  a key card
  a code
  a mysterious stone
  a special goggles (being worn)
  a Stone axe
  a fishing rod
  a rusty key

>x battery
A fully charged battery.

>fix sub
You plug the charged battery into the empty space next to the engine. You climb into the submarine and start the engine. The propeller successfuly starts and you begin your descent away from the island.

    *** You have won ***

Would you like to RESTART, RESTORE a saved game, QUIT or UNDO the last command?

>undo
underground cove
[Previous turn undone.]

>place battery in sub
You plug the charged battery into the empty space next to the engine. You climb into the submarine and start the engine. The propeller successfuly starts and you begin your descent away from the island.

    *** You have won ***

Would you like to RESTART, RESTORE a saved game, QUIT or UNDO the last command?

* * *

>n
Clearing
A wide open grassy clearing that is surrounded by a ring of palm trees. You can see a feeble lone tree in the center of the clearing and a cluster of boulders near the edge of the clearing. You can also see a mud pit near the boulders. Four paths from all directions intersect here. The volcano slope is to the north, the dirt path is to the west, the wetlands are to the east, and the beach is to the south.

>shake tree
You grab hold of the feeble trunk and shake it violently. A skinny branch detaches iteself from the trunk and falls to the ground. You take a closer look at the branch and see that it is actually a strong, flexible stick.

* * *

>take stick
Taken.

>combine stick and line
You can't use multiple objects with that verb.

* * *

>take worm
Taken.

>shake tre
You can't see any such thing.

>shake tree
You grab hold of the feeble trunk and shake it gently. A skinny branch detaches iteself from the trunk and falls to the ground. You take a closer look at the branch and see that it is actually a strong, flexible stick.

>take stick
Taken.

>combine stick with line
You tie the fishing line into a notch at the end of the stick. You have created an unfinished rod.

* * *

>combine rod with worm
You tie the worm to the end of the fishing line on the unfinished rod. You have created a fishing rod.

>e
Wetlands
A series of small ponds surrounded by tall grass and mangrove plants. The lava tube is to the north and the clearing is to the west.

>fish
(in the small ponds)
You throw your line in the pond and wait for a bite. It's not long until you feel something tugging on your line. You pull in your line and take the raw mullet on the end.

>i
You are carrying:
  a raw mullet
  a fishing rod

>fish
(in the small ponds)
You already have a fish!

>drop fish
Dropped.

>take fish
Taken.

>drop fish
Dropped.

>fish
(in the small ponds)
You throw your line in the pond and wait for a bite. It's not long until you feel something tugging on your line. You pull in your line and take the raw mullet on the end.

* * *

>i
You are carrying:
  a raw mullet
  a fishing rod

>take fish
You already have that.

>i
You are carrying:
  a raw mullet
  a fishing rod

>e
You can't go that way.

>n
Lava Tube
An old lava tube that is now empty. There are strange markings engraved into the shiny black rock walls.

>e
You can't go that way.

* * *

>w
Volcano Slope
The slope of a towering active volcano in the middle of the island. The slope is covered with ash and underbrush. There is a small lava pit at the foot of the slope. The lava tube is to the east and the clearing is to the south.

>cook fish
(in the small lava pit)
You carefully hold the raw mullet over the fire pit. After a while, the mullet cooks and becomes brown and crispy. You now have a cooked mullet.

>i
You are carrying:
  a cooked mullet
  a fishing rod

>e
Lava Tube
An old lava tube that is now empty. There are strange markings engraved into the shiny black rock walls.

>n
You can't go that way.

>s
Wetlands
A series of small ponds surrounded by tall grass and mangrove plants. The lava tube is to the north and the clearing is to the west.

>fish
(in the small ponds)
You throw your line in the pond and wait for a bite. It's not long until you feel something tugging on your line. You pull in your line and take the raw mullet on the end.

>i
You are carrying:
  a raw mullet
  a cooked mullet
  a fishing rod

>n
Lava Tube
An old lava tube that is now empty. There are strange markings engraved into the shiny black rock walls.

>w
Volcano Slope
The slope of a towering active volcano in the middle of the island. The slope is covered with ash and underbrush. There is a small lava pit at the foot of the slope. The lava tube is to the east and the clearing is to the south.

* * *

>cook fish
(in the small lava pit)
You carefully hold the raw mullet over the fire pit. After a while, the mullet cooks and becomes brown and crispy. You now have a cooked mullet.

>e
Lava Tube
An old lava tube that is now empty. There are strange markings engraved into the shiny black rock walls.

>s
Wetlands
A series of small ponds surrounded by tall grass and mangrove plants. The lava tube is to the north and the clearing is to the west.

* * *

>i
You are carrying:
  a raw mullet
  a cooked mullet
  a fishing rod

>fish
(in the small ponds)
You already have a fish!

>i
You are carrying:
  a raw mullet
  a cooked mullet
  a fishing rod

* * *

>take line
Taken.

>x hole
Quarter-sized holes that are scattered all around the shore line.

Something shiny catches your eye in one of the holes near your feet. You take a closer look and see that it's a rusty key.

* * *

>x sand
Very fine white sand that is warm to the touch.

>x beach
You can't see any such thing.

* * *

>x island
You're standing on it!

>x waves
Crystal clear sea water gently lapping the white sand.

* * *

>x ocean
A beautiful, sparkling, sapphire ocean that stretches to the horizon.

>x shore
You can't see any such thing.

* * *

>x hole
Quarter-sized holes that are scattered all around the shore line.

Something shiny catches your eye in one of the holes near your feet. You take a closer look and see that it's a rusty key.

* * *

>n
Clearing
A wide open grassy clearing that is surrounded by a ring of palm trees. You can see a feeble lone tree in the center of the clearing and a cluster of boulders near the edge of the clearing. You can also see a mud pit near the boulders. Four paths from all directions intersect here. The volcano slope is to the north, the dirt path is to the west, the wetlands are to the east, and the beach is to the south.

>w
Dirt Path
An old dirt path lined with greenery. There is a hut to the north and a gate to the west.

You can see a wooden handle here.

>unlock gate
(with the rusty key)
You unlock the Gate.

>open gate
You open the Gate.

* * *

>w
Cave
A dark and spacious cave that seems to extend much farther undergound. The only sound that can be heard here is the water droplets falling from the ceiling. The dirt path is to the east.

You can see a mysterious stone here.

>take stone
Taken.

>e
Dirt Path
An old dirt path lined with greenery. There is a hut to the north and a gate to the west.

You can see a wooden handle here.

>n
The wooden door to the shack won't budge. It is locked with wooden planks that are nailed to the front of the door. Maybe you could somehow break them.

>e
Clearing
A wide open grassy clearing that is surrounded by a ring of palm trees. You can see a feeble lone tree in the center of the clearing and a cluster of boulders near the edge of the clearing. You can also see a mud pit near the boulders. Four paths from all directions intersect here. The volcano slope is to the north, the dirt path is to the west, the wetlands are to the east, and the beach is to the south.

* * *

>n
Volcano Slope
The slope of a towering active volcano in the middle of the island. The slope is covered with ash and underbrush. There is a small lava pit at the foot of the slope. The lava tube is to the east and the clearing is to the south.

>unlock hidden door with stone
You unlock the Hidden Door.

>open door
You open the Hidden Door.

* * *

>n
Dark Tunnel
A dark tunnel dug under the slope of the volcano that looks to be man-made. The air is warm and the walls are lined with broken tunnel lights. Further down the tunnel, there are two large metal doors. One is to the north and one is to the east. There is an electronic keypad mounted on the wall between the two doors.

>x wall
Rugged stone walls that are lined with broken tunnel lights.

>x lights
Light strips that are built into the walls of the tunnel. The lights are burned out and are no longer working.

>x metal door
Which do you mean, the North Metal Door or the East Metal Door?

>north metal door
A metal door that slides open from the middle.

>x east metal door
A metal door that slides open from the middle.

* * *

>take key
Taken.

>take line
Taken.

* * *

>take stick
Taken.

>take worm
Taken.

* * *

>take rock
Taken.

>combine stick with line
You tie the fishing line into a notch at the end of the stick. You have created an unfinished rod.

* * *

>combine handle with rock
You shove the sharp rock into the wooden handle. You have created a stone axe.

>break door with axe
You chop and break the wooden planks. You can now open the door.

>open door
You open the Wooden Door.

* * *

>n
Old Shack
A dark and musty shack. The walls are lined with shelves that hold misshapen skulls, flasks, and other unusual objects. How odd. The dirt path is to the south.

You can see a Scientist here.

>give scientist mullet
The scientist hungrily snatches the cooked mullet out of your hands.

* * *

>s
Dirt Path
An old dirt path lined with greenery. There is a hut to the north and a gate to the west.

>unlock gate with key
You unlock the Gate.

>open gate
You open the Gate.

* * *

>take stone
(the mysterious stone)
Taken.

>e
Dirt Path
An old dirt path lined with greenery. There is a hut to the north and a gate to the west.

* * *

>x wall
The special goggles filter the markings on the wall, leaving only the faint scratches visible. You can clearly make out the number "133716" engraved in the wall. You pick up a leaf and scratch the number in with your fingernail. You put the leaf in your pocket.

>w
Volcano Slope
The slope of a towering active volcano in the middle of the island. The slope is covered with ash and underbrush. There is a small lava pit at the foot of the slope. The lava tube is to the east and the clearing is to the south.

>open hidden door with stone
Which do you mean, the mysterious stone or the Stone axe?

>mysterious stone
You unlock the Hidden Door.

* * *

>e
Secret Lab
A secret lab built under a volcano? Sounds like something straight out of a sci-fi movie! Flasks and beakers of different shapes and sizes line the shelves and tabletops. Rows of beeping machines are located in the far corner of the lab. The dark tunnel is to the east and the experiment room is to the north.

You can see an uncharged battery and a key card here.

>take beaker
You don't need that.

>take flask
You don't need that.

>press buttons
Let's not mess with anything here.

>press button
Let's not mess with anything here.

>x machines
Computer-like machines that are covered with multiple buttons and screens.

>n
Experiment Room
A dark room packed with empty animal pens and cages. Giant claw marks stretch across the blood-stained walls. There are three large cryo tubes sitting in the middle of the room. Next to one of the cryo tubes is a small sample safe. The underground cove is to the west and the secret lab is to the south.

You can see a sample safe (closed) here.

>x pens
Empty cages and pens that looks to once have held many different types of animals.

>x wall
Walls that are covered with somebody's or something's blood.

>x tube
Three tall capsules that are each filled with greenish liquids. Although empty now, they serve as storage units for holding bodies.

>x liquid
A strange green liquid. Who knows what it is?

>x sample safe
A small glass sample safe that contains three liquid-filled vials labeled x, y, and z. There is a card slot on the safe door.

>take sample safe
It's too heavy to carry.

>w
Underground Cove
A hidden cove where the ocean flows underneath the volcano. This cove serves as a secret lab entrance for boats and other ocean vehicles. There is a small submarine floating in the water. The dark tunnel is to the south and the experiment room is to the east.

You can see a Broken submarine (empty) here.

>x sub
A broken one-passenger submarine bobbing in the water. There is an empty slot near the engine. Maybe the submarine can be fixed…

* * *

>x water
Seawater that flowed in from the outside.

* * *

>n
Clearing
A wide open grassy clearing that is surrounded by a ring of palm trees. You can see a feeble lone tree in the center of the clearing and a cluster of boulders near the edge of the clearing. You can also see a mud pit near the boulders. Four paths from all directions intersect here. The volcano slope is to the north, the dirt path is to the west, the wetlands are to the east, and the beach is to the south.

You must supply a noun.

>kick lone tree
You kick feeble trunk. A skinny branch detaches iteself from the trunk and falls to the ground. You take a closer look at the branch and see that it is actually a strong, flexible stick.

>kick lone tree
You kick feeble trunk. A skinny branch detaches iteself from the trunk and falls to the ground. You take a closer look at the branch and see that it is actually a strong, flexible stick.

>take stick
Taken.

>kick lone tree
You kick the feeble trunk but nothing happens.

>w
Dirt Path
An old dirt path lined with greenery. There is a hut to the north and a gate to the west.

You can see a wooden handle here.

>w
The gate at the cave entrance is locked.

>x hut
A round and old wooden shack with a pointed straw roof. The walls of the shack are lined with giant scratches that look like claw marks.

* * *

>n
The wooden door to the shack won't budge. It is locked with wooden planks that are nailed to the front of the door. Maybe you could somehow break them.

>w
The gate at the cave entrance is locked.

>w
The gate at the cave entrance is locked.

>i
You are carrying:
  a flexible stick

>e
Clearing
A wide open grassy clearing that is surrounded by a ring of palm trees. You can see a feeble lone tree in the center of the clearing and a cluster of boulders near the edge of the clearing. You can also see a mud pit near the boulders. Four paths from all directions intersect here. The volcano slope is to the north, the dirt path is to the west, the wetlands are to the east, and the beach is to the south.

>s
Beach
A beautiful white sand beach that stretches around the entire island. Waves from the vast, sapphire ocean gently lap the shore. The sand here is littered with many crab holes. Palm trees line the dirt farther north up the beach. The clearing is to the north.

You can see a thin line here.

>x hole
Quarter-sized holes that are scattered all around the shore line.

Something shiny catches your eye in one of the holes near your feet. You take a closer look and see that it's a rusty key.

* * *

>w
Cave
A dark and spacious cave that seems to extend much farther undergound. The only sound that can be heard here is the water droplets falling from the ceiling. The dirt path is to the east.

You can see a mysterious stone here.

>e
Dirt Path
An old dirt path lined with greenery. There is a hut to the north and a gate to the west.

You can see a wooden handle here.

>x gate
A giant gate that covers the entire mouth of a cave. The gate is littered with warning and danger signs. How eerie. On the front of the gate is a keyhole in the shape of an hourglass. This gate is probably here for a reason…

>l
Dirt Path
An old dirt path lined with greenery. There is a hut to the north and a gate to the west.

You can see a wooden handle here.

>x gate
A giant gate that covers the entire mouth of a cave. The gate is littered with warning and danger signs. How eerie. On the front of the gate is a keyhole in the shape of an hourglass. This gate is probably here for a reason…

>open gate
That's already open.

>w
Cave
A dark and spacious cave that seems to extend much farther undergound. The only sound that can be heard here is the water droplets falling from the ceiling. The dirt path is to the east.

You can see a mysterious stone here.

* * *

>e
Dirt Path
An old dirt path lined with greenery. There is a hut to the north and a gate to the west.

You can see a wooden handle here.

>take handle
Taken.

>w
Cave
A dark and spacious cave that seems to extend much farther undergound. The only sound that can be heard here is the water droplets falling from the ceiling. The dirt path is to the east.

You can see a mysterious stone here.

* * *

>take stone
Taken.

>e
Dirt Path
An old dirt path lined with greenery. There is a hut to the north and a gate to the west.

* * *

>e
Clearing
A wide open grassy clearing that is surrounded by a ring of palm trees. You can see a feeble lone tree in the center of the clearing and a cluster of boulders near the edge of the clearing. You can also see a mud pit near the boulders. Four paths from all directions intersect here. The volcano slope is to the north, the dirt path is to the west, the wetlands are to the east, and the beach is to the south.

>take rock
Taken.

>combine rock with handle
You shove the sharp rock into the wooden handle. You have created a stone axe.

>w
Dirt Path
An old dirt path lined with greenery. There is a hut to the north and a gate to the west.

>cut planks
You must supply a second noun.

>cut planks with axe
You chop and break the wooden planks. You can now open the door.

* * *

>n
Old Shack
A dark and musty shack. The walls are lined with shelves that hold misshapen skulls, flasks, and other unusual objects. How odd. The dirt path is to the south.

You can see a Scientist here.

>attack man
The last thing you would want to do when you're stranded on an island is to attack a potential ally.

>talk to man
Food…please…

* * *

>n
Clearing
A wide open grassy clearing that is surrounded by a ring of palm trees. You can see a feeble lone tree in the center of the clearing and a cluster of boulders near the edge of the clearing. You can also see a mud pit near the boulders. Four paths from all directions intersect here. The volcano slope is to the north, the dirt path is to the west, the wetlands are to the east, and the beach is to the south.

You must supply a noun.

>x rocks
small rocks that are scattered around the boulders.

>small
That's not a verb I recognise.

>x pit
A small pit filled with warm, thick mud.

You can see a worm on the surface of the mud.

>x mud
A small pit filled with warm, thick mud.

You can see a worm on the surface of the mud.

>x paths
Four different paths that exit to the north, south, east, and west.

>w
Dirt Path
An old dirt path lined with greenery. There is a hut to the north and a gate to the west.

You can see a wooden handle here.

>x greenery
Various bushes and trees that line the dirt path.

>x hut
A round and old wooden shack with a pointed straw roof. The walls of the shack are lined with giant scratches that look like claw marks.

>x gate
A giant gate that covers the entire mouth of a cave. The gate is littered with warning and danger signs. How eerie. On the front of the gate is a keyhole in the shape of an hourglass. This gate is probably here for a reason…

>x scratches
Claw marks on the outside of the shack that look like they were made by something big.

>x scratch
Claw marks on the outside of the shack that look like they were made by something big.

>x claw marks
Claw marks on the outside of the shack that look like they were made by something big.

>x roof
A pointed roof made of straw.

>x cave
You can't see any such thing.

>x danger signs
Danger and warning signs meant to keep people away. The question is why?

>x signs
Danger and warning signs meant to keep people away. The question is why?

>x sign
Danger and warning signs meant to keep people away. The question is why?

>x danger and warning signs
Danger and warning signs meant to keep people away. The question is why?

>x keyhole
An hourglass-shaped keyhole.

>x keyhole
An hourglass-shaped keyhole.

>n
The wooden door to the shack won't budge. It is locked with wooden planks that are nailed to the front of the door. Maybe you could somehow break them.

>x planks
A wooden door that is covered in slash marks. Whatever left the marks must've been pretty big…

>take handle
Taken.

>i
You are carrying:
  a wooden handle

>e
Clearing
A wide open grassy clearing that is surrounded by a ring of palm trees. You can see a feeble lone tree in the center of the clearing and a cluster of boulders near the edge of the clearing. You can also see a mud pit near the boulders. Four paths from all directions intersect here. The volcano slope is to the north, the dirt path is to the west, the wetlands are to the east, and the beach is to the south.

>take stone
You can't see any such thing.

>take rock
Taken.

* * *

>n
Old Shack
A dark and musty shack. The walls are lined with shelves that hold misshapen skulls, flasks, and other unusual objects. How odd. The dirt path is to the south.

You can see a Scientist here.

>x walls
Walls lined with shelves.

>x skulls
Unusual skulls that don't resemble the skull of anything you are familiar with.

>x flasks
Various types of flasks that you recognize from chemistry class.

>x objects
Unusual science objects.

>s
Dirt Path
An old dirt path lined with greenery. There is a hut to the north and a gate to the west.

* * *

>w
The gate at the cave entrance is locked.

>e
Clearing
A wide open grassy clearing that is surrounded by a ring of palm trees. You can see a feeble lone tree in the center of the clearing and a cluster of boulders near the edge of the clearing. You can also see a mud pit near the boulders. Four paths from all directions intersect here. The volcano slope is to the north, the dirt path is to the west, the wetlands are to the east, and the beach is to the south.

* * *

>w
Dirt Path
An old dirt path lined with greenery. There is a hut to the north and a gate to the west.

>unlock gate
What do you want to unlock the Gate with?

* * *

>w
Cave
A dark and spacious cave that seems to extend much farther undergound. The only sound that can be heard here is the water droplets falling from the ceiling. The dirt path is to the east.

You can see a mysterious stone here.

>x drops
It's too dark to see the water droplets. You can only hear them hitting the cave floor.

>x floor
A hard stone floor.

>x ceiling
It's too dark to see the ceiling.

>e
Dirt Path
An old dirt path lined with greenery. There is a hut to the north and a gate to the west.

* * *

>e
Wetlands
A series of small ponds surrounded by tall grass and mangrove plants. The lava tube is to the north and the clearing is to the west.

>x grass
Tall grass and reeds that come up to your waist.

>x plants
Mangrove plants that are elevated above the ground on their tall roots.

>n
Lava Tube
An old lava tube that is now empty. There are strange markings engraved into the shiny black rock walls.

>x rock walls
Cave paintings and hieroglyphs that look to have been engraved into the rock wall long ago. There are also some faint scratches that look out of place.

>e
You can't go that way.

* * *

>w
Volcano Slope
The slope of a towering active volcano in the middle of the island. The slope is covered with ash and underbrush. There is a small lava pit at the foot of the slope. The lava tube is to the east and the clearing is to the south.

>x volcano
A towering volcano thats peak is hidden in the clouds. The underbrush covering the volcano looks a little strange.

>x mountain
A towering volcano thats peak is hidden in the clouds. The underbrush covering the volcano looks a little strange.

>x volcano slope
I only understood you as far as wanting to examine the mountain.

>x underbrush
Volcanic ferns and skinny trees that are rooted on the slope of the volcano. You notice a door built into the side of the volcano behind one of the ferns.

>x ferns
Volcanic ferns and skinny trees that are rooted on the slope of the volcano. You notice a door built into the side of the volcano behind one of the ferns.

* * *

>n
Clearing
A wide open grassy clearing that is surrounded by a ring of palm trees. You can see a feeble lone tree in the center of the clearing and a cluster of boulders near the edge of the clearing. You can also see a mud pit near the boulders. Four paths from all directions intersect here. The volcano slope is to the north, the dirt path is to the west, the wetlands are to the east, and the beach is to the south.

You must supply a noun.

>e
Wetlands
A series of small ponds surrounded by tall grass and mangrove plants. The lava tube is to the north and the clearing is to the west.

You must supply a noun.

>w
Clearing
A wide open grassy clearing that is surrounded by a ring of palm trees. You can see a feeble lone tree in the center of the clearing and a cluster of boulders near the edge of the clearing. You can also see a mud pit near the boulders. Four paths from all directions intersect here. The volcano slope is to the north, the dirt path is to the west, the wetlands are to the east, and the beach is to the south.

You must supply a noun.

>w
Dirt Path
An old dirt path lined with greenery. There is a hut to the north and a gate to the west.

You can see a wooden handle here.

You must supply a noun.

>w
The gate at the cave entrance is locked.

You must supply a noun.

>e
Clearing
A wide open grassy clearing that is surrounded by a ring of palm trees. You can see a feeble lone tree in the center of the clearing and a cluster of boulders near the edge of the clearing. You can also see a mud pit near the boulders. Four paths from all directions intersect here. The volcano slope is to the north, the dirt path is to the west, the wetlands are to the east, and the beach is to the south.

You must supply a noun.

>s
Beach
A beautiful white sand beach that stretches around the entire island. Waves from the vast, sapphire ocean gently lap the shore. The sand here is littered with many crab holes. Palm trees line the dirt farther north up the beach. The clearing is to the north.

You can see a thin line here.

You must supply a noun.

>s
You can't go that way.

You must supply a noun.

>w
You can't go that way.

You must supply a noun.

>s
You can't go that way.

You must supply a noun.

* * *

>w
You can't go that way.

You must supply a noun.

>n
Clearing
A wide open grassy clearing that is surrounded by a ring of palm trees. You can see a feeble lone tree in the center of the clearing and a cluster of boulders near the edge of the clearing. You can also see a mud pit near the boulders. Four paths from all directions intersect here. The volcano slope is to the north, the dirt path is to the west, the wetlands are to the east, and the beach is to the south.

You must supply a noun.

>n
Volcano Slope
The slope of a towering active volcano in the middle of the island. The slope is covered with ash and underbrush. There is a small lava pit at the foot of the slope. The lava tube is to the east and the clearing is to the south.

You must supply a noun.

>s
Clearing
A wide open grassy clearing that is surrounded by a ring of palm trees. You can see a feeble lone tree in the center of the clearing and a cluster of boulders near the edge of the clearing. You can also see a mud pit near the boulders. Four paths from all directions intersect here. The volcano slope is to the north, the dirt path is to the west, the wetlands are to the east, and the beach is to the south.

You must supply a noun.

>e
Wetlands
A series of small ponds surrounded by tall grass and mangrove plants. The lava tube is to the north and the clearing is to the west.

You must supply a noun.

* * *

>s
Clearing
A wide open grassy clearing that is surrounded by a ring of palm trees. You can see a feeble lone tree in the center of the clearing and a cluster of boulders near the edge of the clearing. You can also see a mud pit near the boulders. Four paths from all directions intersect here. The volcano slope is to the north, the dirt path is to the west, the wetlands are to the east, and the beach is to the south.

You must supply a noun.

>s
Beach
A beautiful white sand beach that stretches around the entire island. Waves from the vast, sapphire ocean gently lap the shore. The sand here is littered with many crab holes. Palm trees line the dirt farther north up the beach. The clearing is to the north.

You can see a thin line here.

You must supply a noun.

>x hole
Quarter-sized holes that are scattered all around the shore line.

Something shiny catches your eye in one of the holes near your feet. You take a closer look and see that it's a rusty key.

You must supply a noun.

>take key
Taken.

You must supply a noun.

>n
Clearing
A wide open grassy clearing that is surrounded by a ring of palm trees. You can see a feeble lone tree in the center of the clearing and a cluster of boulders near the edge of the clearing. You can also see a mud pit near the boulders. Four paths from all directions intersect here. The volcano slope is to the north, the dirt path is to the west, the wetlands are to the east, and the beach is to the south.

You must supply a noun.

>w
Dirt Path
An old dirt path lined with greenery. There is a hut to the north and a gate to the west.

You can see a wooden handle here.

You must supply a noun.

* * *

>w
The gate at the cave entrance is locked.

You must supply a noun.

>unlock gate with key
You unlock the Gate.

You must supply a noun.

>open gate
You open the Gate.

You must supply a noun.

>w
Cave
A dark and spacious cave that seems to extend much farther undergound. The only sound that can be heard here is the water droplets falling from the ceiling. The dirt path is to the east.

You can see a mysterious stone and Bob here.

"Hey, I'm bored," Bob says. "Let's go for a ramble."

>n
You can't go that way.

"Hey, I'm bored," Bob says. "Let's go for a ramble."

>n
You can't go that way.

"Hey, I'm bored," Bob says. "Let's go for a ramble."

>e
Dirt Path
An old dirt path lined with greenery. There is a hut to the north and a gate to the west.

You can see a wooden handle here.

You must supply a noun.

>x handle
A curved piece of wood that resembles the handle of an axe.

You must supply a noun.

>x bobo
You can't see any such thing.

>x bob
You can't see any such thing.

>w
Cave
A dark and spacious cave that seems to extend much farther undergound. The only sound that can be heard here is the water droplets falling from the ceiling. The dirt path is to the east.

You can see a mysterious stone and Bob here.

"Hey, I'm bored," Bob says. "Let's go for a ramble."

>e
Dirt Path
An old dirt path lined with greenery. There is a hut to the north and a gate to the west.

You can see a wooden handle here.

You must supply a noun.

* * *

>x handle
A curved piece of wood that resembles the handle of an axe.

You must supply a noun.

>x bob
You can't see any such thing.

>e
Clearing
A wide open grassy clearing that is surrounded by a ring of palm trees. You can see a feeble lone tree in the center of the clearing and a cluster of boulders near the edge of the clearing. You can also see a mud pit near the boulders. Four paths from all directions intersect here. The volcano slope is to the north, the dirt path is to the west, the wetlands are to the east, and the beach is to the south.

You must supply a noun.

>w
Dirt Path
An old dirt path lined with greenery. There is a hut to the north and a gate to the west.

You can see a wooden handle here.

You must supply a noun.

>w
Cave
A dark and spacious cave that seems to extend much farther undergound. The only sound that can be heard here is the water droplets falling from the ceiling. The dirt path is to the east.

You can see a mysterious stone and Bob here.

"Hey, I'm bored," Bob says. "Let's go for a ramble."

* * *

>x line
A long, tough fishing line that washed up on the beach.

>eat line
(first taking the thin line)
That's plainly inedible.

>get line
You already have that.

>talk to line
You can only do that to something animate.

>walk
You'll have to say which compass direction to go in.

>walk foward
You can't see any such thing.

>walk forward
You can't see any such thing.

>walk north
Clearing
A wide open grassy clearing that is surrounded by a ring of palm trees. You can see a feeble lone tree in the center of the clearing and a cluster of boulders near the edge of the clearing. You can also see a mud pit near the boulders. Four paths from all directions intersect here. The volcano slope is to the north, the dirt path is to the west, the wetlands are to the east, and the beach is to the south.

>go north
Volcano Slope
The slope of a towering active volcano in the middle of the island. The slope is covered with ash and underbrush. There is a small lava pit at the foot of the slope. The lava tube is to the east and the clearing is to the south.

>swim in lava
That's not a verb I recognise.

>go to lava
You can't see any such thing.

>go east
Lava Tube
An old lava tube that is now empty. There are strange markings engraved into the shiny black rock walls.

>look at wall
Cave paintings and hieroglyphs that look to have been engraved into the rock wall long ago. There are also some faint scratches that look out of place.

>take wall
That's hardly portable.

>x wall
Cave paintings and hieroglyphs that look to have been engraved into the rock wall long ago. There are also some faint scratches that look out of place.

>go south
Wetlands
A series of small ponds surrounded by tall grass and mangrove plants. The lava tube is to the north and the clearing is to the west.

>x plants
Mangrove plants that are elevated above the ground on their tall roots.

>take plants
That's hardly portable.

>give me mangos
You can't see any such thing.

>give me win
You can't see any such thing.

>bad game
That's not a verb I recognise.

>i quit
I only understood you as far as wanting to take inventory.